关键词	百度搜索量	百度指数	百度周指数	移动指数	移动周指数	整体指数	整体周指数	搜狗指数	周指数	360相关页	百度相关页	首页数	广告	KR	KPI	难度	来源
玛卡	11900	3072	21504	5517	38619	8589	60123	0	21504	0	20100000	60	0	6	1.2	较难	批量查询
玛卡的功效	4300	809	5663	1615	11305	2424	16968	0	5663	0	13700000	54	0	6	1.3	较难	批量查询
玛卡怎么吃	1400	0	0	0	0	0	0	0	0	0	5750000	15	0	3	2	较易	批量查询
玛卡价格	970	102	714	1925	13475	2027	14189	0	714	0	20400000	41	0	5	1.3	较难	批量查询
玛卡是什么	840	311	2177	1640	11480	1951	13657	0	2177	0	2440000	22	0	3	1.9	较易	批量查询
秘鲁玛卡	810	242	1694	321	2247	563	3941	0	1694	0	3780000	35	0	4	1.5	较易	批量查询
玛卡官网	590	151	1057	1529	10703	1680	11760	0	1057	0	6420000	78	0	7	0.9	难	批量查询
玛卡益康片	580	181	1267	162	1134	343	2401	0	1267	0	1050000	18	0	3	1.8	较易	批量查询
玛卡真的有效果吗	460	0	0	0	0	0	0	0	0	0	1530000	7	0	2	2.3	容易	批量查询
玛卡果	280	0	0	0	0	0	0	0	0	0	1070000	27	0	4	1.3	较易	批量查询
秘鲁玛卡效果怎么样	260	0	0	0	0	0	0	0	0	0	2120000	14	0	3	1.6	较易	批量查询
玛卡益康咀嚼片	210	0	0	0	0	0	0	0	0	0	1540000	24	0	4	1.3	较易	批量查询
谁吃过玛卡怎么样	210	0	0	0	0	0	0	0	0	0	6330000	8	0	3	1.6	较易	批量查询
玛卡益康	200	129	903	1508	10556	1637	11459	0	903	0	2750000	20	0	3	1.6	较易	批量查询
玛卡的功效与作用	200	0	0	0	0	0	0	0	0	0	840000	32	0	4	1.3	较易	批量查询
玛卡片	190	147	1029	121	847	268	1876	0	1029	0	6710000	19	0	3	1.5	较易	批量查询
玛卡价格多少钱一克	180	0	0	0	0	0	0	0	0	0	106000	22	0	3	1.5	较易	批量查询
黑玛卡	170	0	0	0	0	0	0	0	0	0	1300000	12	0	3	1.5	较易	批量查询
云南玛卡价格	167	0	0	0	0	0	0	0	0	0	1680000	16	0	3	1.5	较易	批量查询
秘鲁玛卡官网	150	96	672	1465	10255	1561	10927	0	672	0	2720000	37	0	4	1.2	较易	批量查询
玛卡西尼	149	125	875	110	770	235	1645	0	875	0	408000	11	0	2	2.1	容易	批量查询
玛卡的副作用	140	0	0	0	0	0	0	0	0	0	9700000	25	0	4	1.2	较易	批量查询
玛卡瑞纳	140	0	0	0	0	0	0	0	0	0	151000	9	0	2	2.1	容易	批量查询
玛卡益康片是真的吗	120	0	0	0	0	0	0	0	0	0	201000	45	0	5	1	较难	批量查询
玛卡怎么吃效果好	120	0	0	0	0	0	0	0	0	0	3610000	38	0	5	1	较难	批量查询
玛卡的价格	120	0	0	0	0	0	0	0	0	0	618000	45	0	5	1	较难	批量查询
玛卡的作用	110	0	0	0	0	0	0	0	0	0	1050000	24	0	3	1.5	较易	批量查询
云南玛卡	105	0	0	0	0	0	0	0	0	0	13000000	34	0	5	1	较难	批量查询
玛卡种植	100	0	0	0	0	0	0	0	0	0	2510000	27	0	4	1.2	较易	批量查询
秘鲁玛卡是真的吗	90	0	0	0	0	0	0	0	0	0	1200000	36	0	4	1.2	较易	批量查询
玛卡之家	90	0	0	0	0	0	0	0	0	0	2430000	9	0	2	1.9	容易	批量查询
秘鲁玛卡价格	90	0	0	0	0	0	0	0	0	0	4720000	14	0	3	1.4	较易	批量查询
玛米玛卡	83	134	938	101	707	235	1645	0	938	0	6330000	14	0	3	1.4	较易	批量查询
玛卡胶囊	80	86	602	115	805	201	1407	0	602	0	2430000	12	0	3	1.4	较易	批量查询
玛卡副作用	70	75	525	99	693	174	1218	0	525	0	2820000	51	0	5	0.9	较难	批量查询
玛卡功效	70	0	0	0	0	0	0	0	0	0	10100000	16	0	3	1.4	较易	批量查询
玛卡亚米	66	9	63	0	0	9	63	0	63	0	81800	4	0	2	1.7	容易	批量查询
玛卡精片	60	0	0	0	0	0	0	0	0	0	1140000	25	0	4	1	较易	批量查询
玛卡吃多久有效果	56	0	0	0	0	0	0	0	0	0	6950000	4	0	2	1.7	容易	批量查询
玛卡有副作用吗	50	78	546	99	693	177	1239	0	546	0	0	0	0	0	0		批量查询
玛卡怎么样	50	56	392	1267	8869	1323	9261	0	392	0	0	0	0	0	0		批量查询
玛卡益康片怎么样	50	0	0	0	0	0	0	0	0	0	0	0	0	0	0		批量查询
玛卡种子	50	0	0	0	0	0	0	0	0	0	0	0	0	0	0		批量查询
玛卡干果	50	0	0	0	0	0	0	0	0	0	0	0	0	0	0		批量查询
玛卡官方网站	50	0	0	0	0	0	0	0	0	0	0	0	0	0	0		批量查询
玛卡效果怎么样	50	0	0	0	0	0	0	0	0	0	0	0	0	0	0		批量查询
玛卡有用吗	50	0	0	0	0	0	0	0	0	0	0	0	0	0	0		批量查询
松古树美玛卡	50	0	0	0	0	0	0	0	0	0	0	0	0	0	0		批量查询
拉摩力拉玛卡片	50	0	0	0	0	0	0	0	0	0	0	0	0	0	0		批量查询
云南玛卡功效	46	0	0	0	0	0	0	0	0	0	0	0	0	0	0		批量查询
丽江玛卡	45	0	0	0	0	0	0	0	0	0	0	0	0	0	0		批量查询
玛卡有效果吗	40	0	0	0	0	0	0	0	0	0	0	0	0	0	0		批量查询
玛卡是真的吗	40	0	0	0	0	0	0	0	0	0	0	0	0	0	0		批量查询
黄金玛卡	40	0	0	0	0	0	0	0	0	0	0	0	0	0	0		批量查询
玛卡的食用方法	40	0	0	0	0	0	0	0	0	0	0	0	0	0	0		批量查询
享硬玛卡浓缩片	40	0	0	0	0	0	0	0	0	0	0	0	0	0	0		批量查询
玛卡干片	40	0	0	0	0	0	0	0	0	0	0	0	0	0	0		批量查询
玛卡益康片有效果吗	35	0	0	0	0	0	0	0	0	0	0	0	0	0	0		批量查询
玛卡粉	31	0	0	0	0	0	0	0	0	0	0	0	0	0	0		批量查询
紫玛卡	30	0	0	0	0	0	0	0	0	0	0	0	0	0	0		批量查询
玛卡益康片官网	30	0	0	0	0	0	0	0	0	0	0	0	0	0	0		批量查询
玛米玛卡童装旗舰店	30	0	0	0	0	0	0	0	0	0	0	0	0	0	0		批量查询
玛卡是什么东西	30	0	0	0	0	0	0	0	0	0	0	0	0	0	0		批量查询
秘鲁玛卡官方网站	30	0	0	0	0	0	0	0	0	0	0	0	0	0	0		批量查询
玛卡食用方法	30	0	0	0	0	0	0	0	0	0	0	0	0	0	0		批量查询
玛卡果怎么吃	30	0	0	0	0	0	0	0	0	0	0	0	0	0	0		批量查询
玛卡作用	30	0	0	0	0	0	0	0	0	0	0	0	0	0	0		批量查询
玛卡咖啡	30	0	0	0	0	0	0	0	0	0	0	0	0	0	0		批量查询
玛卡提取物	30	0	0	0	0	0	0	0	0	0	0	0	0	0	0		批量查询
有谁吃过玛卡	30	0	0	0	0	0	0	0	0	0	0	0	0	0	0		批量查询
玛卡有没有副作用	30	0	0	0	0	0	0	0	0	0	0	0	0	0	0		批量查询
玛卡真的有效吗	30	0	0	0	0	0	0	0	0	0	0	0	0	0	0		批量查询
玛卡中国总代理	29	0	0	0	0	0	0	0	0	0	0	0	0	0	0		批量查询
吃玛卡有副作用吗	26	0	0	0	0	0	0	0	0	0	0	0	0	0	0		批量查询
玛米玛卡momoco	25	0	0	0	0	0	0	0	0	0	0	0	0	0	0		批量查询
云南丽江玛卡	22	0	0	0	0	0	0	0	0	0	0	0	0	0	0		批量查询
极卡纯玛卡	21	0	0	0	0	0	0	0	0	0	0	0	0	0	0		批量查询
玛卡西尼官网	21	0	0	0	0	0	0	0	0	0	0	0	0	0	0		批量查询
国产玛卡	20	0	0	0	0	0	0	0	0	0	0	0	0	0	0		批量查询
玛卡之家官网	20	0	0	0	0	0	0	0	0	0	0	0	0	0	0		批量查询
玛卡瑞娜	20	0	0	0	0	0	0	0	0	0	0	0	0	0	0		批量查询
玛卡效果	20	0	0	0	0	0	0	0	0	0	0	0	0	0	0		批量查询
玛卡果是什么	20	0	0	0	0	0	0	0	0	0	0	0	0	0	0		批量查询
秘鲁玛卡胶囊	20	0	0	0	0	0	0	0	0	0	0	0	0	0	0		批量查询
秘鲁玛卡副作用	20	0	0	0	0	0	0	0	0	0	0	0	0	0	0		批量查询
秘鲁玛卡图片	20	0	0	0	0	0	0	0	0	0	0	0	0	0	0		批量查询
玛卡批发	20	0	0	0	0	0	0	0	0	0	0	0	0	0	0		批量查询
进口玛卡	20	0	0	0	0	0	0	0	0	0	0	0	0	0	0		批量查询
玛卡益康片有用吗	20	0	0	0	0	0	0	0	0	0	0	0	0	0	0		批量查询
拉摩力拉牌玛卡	20	0	0	0	0	0	0	0	0	0	0	0	0	0	0		批量查询
倍斯万玛卡益康片	20	0	0	0	0	0	0	0	0	0	0	0	0	0	0		批量查询
玛卡服用方法	20	0	0	0	0	0	0	0	0	0	0	0	0	0	0		批量查询
玛卡多少钱一克	20	0	0	0	0	0	0	0	0	0	0	0	0	0	0		批量查询
玛卡多少钱一盒	20	0	0	0	0	0	0	0	0	0	0	0	0	0	0		批量查询
玛卡真的有用吗	20	0	0	0	0	0	0	0	0	0	0	0	0	0	0		批量查询
玛卡保健品	20	0	0	0	0	0	0	0	0	0	0	0	0	0	0		批量查询
天然玛卡	20	0	0	0	0	0	0	0	0	0	0	0	0	0	0		批量查询
秘鲁玛卡片	20	0	0	0	0	0	0	0	0	0	0	0	0	0	0		批量查询
玛卡益康片有效吗	20	0	0	0	0	0	0	0	0	0	0	0	0	0	0		批量查询
玛卡哪里有卖	20	0	0	0	0	0	0	0	0	0	0	0	0	0	0		批量查询
玛卡干果价格	20	0	0	0	0	0	0	0	0	0	0	0	0	0	0		批量查询
黄金玛卡胶囊	20	0	0	0	0	0	0	0	0	0	0	0	0	0	0		批量查询
玛卡什么牌子好	20	0	0	0	0	0	0	0	0	0	0	0	0	0	0		批量查询
玛卡管用吗	20	0	0	0	0	0	0	0	0	0	0	0	0	0	0		批量查询
玛米玛卡童装官网	20	0	0	0	0	0	0	0	0	0	0	0	0	0	0		批量查询
玛卡产品	20	0	0	0	0	0	0	0	0	0	0	0	0	0	0		批量查询
玛卡莱娜	18	0	0	0	0	0	0	0	0	0	0	0	0	0	0		批量查询
玛卡胶囊管用吗	17	0	0	0	0	0	0	0	0	0	0	0	0	0	0		批量查询
活力达秘鲁进口玛卡精片	16	0	0	0	0	0	0	0	0	0	0	0	0	0	0		批量查询
玛卡的吃法	13	0	0	0	0	0	0	0	0	0	0	0	0	0	0		批量查询
玛卡图片	13	0	0	0	0	0	0	0	0	0	0	0	0	0	0		批量查询
云南玛卡的功效	12	0	0	0	0	0	0	0	0	0	0	0	0	0	0		批量查询
美国玛卡	12	0	0	0	0	0	0	0	0	0	0	0	0	0	0		批量查询
玛卡秘鲁	11	0	0	0	0	0	0	0	0	0	0	0	0	0	0		批量查询
玛米玛卡童装加盟	11	0	0	0	0	0	0	0	0	0	0	0	0	0	0		批量查询
玛米玛卡官网	11	0	0	0	0	0	0	0	0	0	0	0	0	0	0		批量查询
拉魔力玛卡	10	0	0	0	0	0	0	0	0	0	0	0	0	0	0		批量查询
玛卡价钱	10	0	0	0	0	0	0	0	0	0	0	0	0	0	0		批量查询
玛卡销售	10	0	0	0	0	0	0	0	0	0	0	0	0	0	0		批量查询
玛卡和玛咖	10	0	0	0	0	0	0	0	0	0	0	0	0	0	0		批量查询
秘鲁玛卡有效果吗	10	0	0	0	0	0	0	0	0	0	0	0	0	0	0		批量查询
正品玛卡	10	0	0	0	0	0	0	0	0	0	0	0	0	0	0		批量查询
秘鲁玛卡官网 makayk	10	0	0	0	0	0	0	0	0	0	0	0	0	0	0		批量查询
玛卡好吗	10	0	0	0	0	0	0	0	0	0	0	0	0	0	0		批量查询
玛卡壮阳	10	0	0	0	0	0	0	0	0	0	0	0	0	0	0		批量查询
玛卡哪有卖	10	0	0	0	0	0	0	0	0	0	0	0	0	0	0		批量查询
玛卡益康官网	10	0	0	0	0	0	0	0	0	0	0	0	0	0	0		批量查询
玛卡的价格是多少	10	0	0	0	0	0	0	0	0	0	0	0	0	0	0		批量查询
玛卡多少钱一瓶	10	0	0	0	0	0	0	0	0	0	0	0	0	0	0		批量查询
秘鲁玛卡怎么样	10	0	0	0	0	0	0	0	0	0	0	0	0	0	0		批量查询
秘鲁黑玛卡	10	0	0	0	0	0	0	0	0	0	0	0	0	0	0		批量查询
玛米玛卡童装价格	10	0	0	0	0	0	0	0	0	0	0	0	0	0	0		批量查询
玛卡果价格	10	0	0	0	0	0	0	0	0	0	0	0	0	0	0		批量查询
玛卡泡酒配方	10	0	0	0	0	0	0	0	0	0	0	0	0	0	0		批量查询
玛卡益康 makayk	10	0	0	0	0	0	0	0	0	0	0	0	0	0	0		批量查询
秘鲁玛卡干果	10	0	0	0	0	0	0	0	0	0	0	0	0	0	0		批量查询
倍斯万玛卡 makayk	10	0	0	0	0	0	0	0	0	0	0	0	0	0	0		批量查询
秘鲁玛卡果	10	0	0	0	0	0	0	0	0	0	0	0	0	0	0		批量查询
享硬玛卡	10	0	0	0	0	0	0	0	0	0	0	0	0	0	0		批量查询
玛卡植物	10	0	0	0	0	0	0	0	0	0	0	0	0	0	0		批量查询
秘鲁玛卡批发	10	0	0	0	0	0	0	0	0	0	0	0	0	0	0		批量查询
玛卡有什么副作用	10	0	0	0	0	0	0	0	0	0	0	0	0	0	0		批量查询
玛卡胶囊效果怎么样	10	0	0	0	0	0	0	0	0	0	0	0	0	0	0		批量查询
玛卡益康片效果怎么样	10	0	0	0	0	0	0	0	0	0	0	0	0	0	0		批量查询
玛卡哪个牌子好	10	0	0	0	0	0	0	0	0	0	0	0	0	0	0		批量查询
活力达秘鲁玛卡精片	10	0	0	0	0	0	0	0	0	0	0	0	0	0	0		批量查询
保健品玛卡	10	0	0	0	0	0	0	0	0	0	0	0	0	0	0		批量查询
秘鲁玛卡真的有效吗	10	0	0	0	0	0	0	0	0	0	0	0	0	0	0		批量查询
玛卡威刚	10	0	0	0	0	0	0	0	0	0	0	0	0	0	0		批量查询
女士玛卡	10	0	0	0	0	0	0	0	0	0	0	0	0	0	0		批量查询
伽玛卡兹鱼钩	10	0	0	0	0	0	0	0	0	0	0	0	0	0	0		批量查询
玛卡胶囊多少钱	10	0	0	0	0	0	0	0	0	0	0	0	0	0	0		批量查询
斯旺森玛卡	10	0	0	0	0	0	0	0	0	0	0	0	0	0	0		批量查询
玛卡金恩	9	0	0	0	0	0	0	0	0	0	0	0	0	0	0		批量查询
云南玛卡专营店	9	0	0	0	0	0	0	0	0	0	0	0	0	0	0		批量查询
中药玛卡	9	0	0	0	0	0	0	0	0	0	0	0	0	0	0		批量查询
秘鲁拉摩力拉玛卡片	8	0	0	0	0	0	0	0	0	0	0	0	0	0	0		批量查询
玛卡西尼官方旗舰店	7	0	0	0	0	0	0	0	0	0	0	0	0	0	0		批量查询
玛卡莲娜	7	0	0	0	0	0	0	0	0	0	0	0	0	0	0		批量查询
玛卡酰胺	6	0	0	0	0	0	0	0	0	0	0	0	0	0	0		批量查询
植物玛卡	6	0	0	0	0	0	0	0	0	0	0	0	0	0	0		批量查询
美国玛卡胶囊	6	0	0	0	0	0	0	0	0	0	0	0	0	0	0		批量查询
享硬玛卡浓缩延时片	6	0	0	0	0	0	0	0	0	0	0	0	0	0	0		批量查询
云南玛卡胶囊	6	0	0	0	0	0	0	0	0	0	0	0	0	0	0		批量查询
玛卡补肾	5	0	0	0	0	0	0	0	0	0	0	0	0	0	0		批量查询
黄金玛卡有副作用吗	5	0	0	0	0	0	0	0	0	0	0	0	0	0	0		批量查询
式玛卡龙油漆	5	0	0	0	0	0	0	0	0	0	0	0	0	0	0		批量查询
哪种玛卡好	4	0	0	0	0	0	0	0	0	0	0	0	0	0	0		批量查询
秘鲁玛卡的功效	4	0	0	0	0	0	0	0	0	0	0	0	0	0	0		批量查询
玛卡好不好	4	0	0	0	0	0	0	0	0	0	0	0	0	0	0		批量查询
拉摩力玛卡	4	0	0	0	0	0	0	0	0	0	0	0	0	0	0		批量查询
哪个牌子的玛卡好	4	0	0	0	0	0	0	0	0	0	0	0	0	0	0		批量查询
玛卡西尼男装	4	0	0	0	0	0	0	0	0	0	0	0	0	0	0		批量查询
美国黄金玛卡	4	0	0	0	0	0	0	0	0	0	0	0	0	0	0		批量查询
玛卡片功效怎么样	4	0	0	0	0	0	0	0	0	0	0	0	0	0	0		批量查询
玛卡牌玛卡益康咀嚼片	4	0	0	0	0	0	0	0	0	0	0	0	0	0	0		批量查询
黄金玛卡怎么样	4	0	0	0	0	0	0	0	0	0	0	0	0	0	0		批量查询
拉摩力拉玛卡官网	4	0	0	0	0	0	0	0	0	0	0	0	0	0	0		批量查询
玛米玛卡童装	4	0	0	0	0	0	0	0	0	0	0	0	0	0	0		批量查询
玛卡功能	4	0	0	0	0	0	0	0	0	0	0	0	0	0	0		批量查询
玛卡湿巾	4	0	0	0	0	0	0	0	0	0	0	0	0	0	0		批量查询
玛卡含片	4	0	0	0	0	0	0	0	0	0	0	0	0	0	0		批量查询
野生玛卡	4	0	0	0	0	0	0	0	0	0	0	0	0	0	0		批量查询
玛卡真假	4	0	0	0	0	0	0	0	0	0	0	0	0	0	0		批量查询
玛卡真假辨别	4	0	0	0	0	0	0	0	0	0	0	0	0	0	0		批量查询
秘鲁玛卡精片	4	0	0	0	0	0	0	0	0	0	0	0	0	0	0		批量查询
秘鲁玛卡真的有用吗	4	0	0	0	0	0	0	0	0	0	0	0	0	0	0		批量查询
玛卡丽娜	4	0	0	0	0	0	0	0	0	0	0	0	0	0	0		批量查询
丽江玛卡价格	4	0	0	0	0	0	0	0	0	0	0	0	0	0	0		批量查询
秘鲁玛卡 makayk	4	0	0	0	0	0	0	0	0	0	0	0	0	0	0		批量查询
玛卡浓缩片	4	0	0	0	0	0	0	0	0	0	0	0	0	0	0		批量查询
玛卡官网 makayk	4	0	0	0	0	0	0	0	0	0	0	0	0	0	0		批量查询
秘鲁玛卡多少钱	4	0	0	0	0	0	0	0	0	0	0	0	0	0	0		批量查询
玛卡秘鲁正品	4	0	0	0	0	0	0	0	0	0	0	0	0	0	0		批量查询
玛卡maca	3	0	0	0	0	0	0	0	0	0	0	0	0	0	0		批量查询
玛卡品牌	3	0	0	0	0	0	0	0	0	0	0	0	0	0	0		批量查询
玛卡功效与作用	3	0	0	0	0	0	0	0	0	0	0	0	0	0	0		批量查询
玛卡收购	3	0	0	0	0	0	0	0	0	0	0	0	0	0	0		批量查询
玛卡泡水	3	0	0	0	0	0	0	0	0	0	0	0	0	0	0		批量查询
谁吃过玛卡	3	0	0	0	0	0	0	0	0	0	0	0	0	0	0		批量查询
秘鲁玛卡怎么吃	3	0	0	0	0	0	0	0	0	0	0	0	0	0	0		批量查询
玛卡益康咀嚼片怎么样	3	0	0	0	0	0	0	0	0	0	0	0	0	0	0		批量查询
玛卡种子价格	3	0	0	0	0	0	0	0	0	0	0	0	0	0	0		批量查询
哪里有玛卡卖	3	0	0	0	0	0	0	0	0	0	0	0	0	0	0		批量查询
秘鲁玛卡益康片	3	0	0	0	0	0	0	0	0	0	0	0	0	0	0		批量查询
古之极玛卡	3	0	0	0	0	0	0	0	0	0	0	0	0	0	0		批量查询
玛卡的副作用是什么	3	0	0	0	0	0	0	0	0	0	0	0	0	0	0		批量查询
秘鲁玛卡有用吗	3	0	0	0	0	0	0	0	0	0	0	0	0	0	0		批量查询
玛卡怎样食用	3	0	0	0	0	0	0	0	0	0	0	0	0	0	0		批量查询
伽玛卡兹矶钓竿	3	0	0	0	0	0	0	0	0	0	0	0	0	0	0		批量查询
新疆玛卡	3	0	0	0	0	0	0	0	0	0	0	0	0	0	0		批量查询
中智玛卡	3	0	0	0	0	0	0	0	0	0	0	0	0	0	0		批量查询
玛卡 玛咖	3	0	0	0	0	0	0	0	0	0	0	0	0	0	0		批量查询
如何食用玛卡	3	0	0	0	0	0	0	0	0	0	0	0	0	0	0		批量查询
玛卡的服用方法	3	0	0	0	0	0	0	0	0	0	0	0	0	0	0		批量查询
玛卡什么颜色的好	3	0	0	0	0	0	0	0	0	0	0	0	0	0	0		批量查询
秘鲁玛卡 骗局	3	0	0	0	0	0	0	0	0	0	0	0	0	0	0		批量查询
玛卡真伪	3	0	0	0	0	0	0	0	0	0	0	0	0	0	0		批量查询
央视玛卡	2	0	0	0	0	0	0	0	0	0	0	0	0	0	0		批量查询
玛卡人生	2	0	0	0	0	0	0	0	0	0	0	0	0	0	0		批量查询
玛卡代理	2	0	0	0	0	0	0	0	0	0	0	0	0	0	0		批量查询
哪里能买到玛卡	2	0	0	0	0	0	0	0	0	0	0	0	0	0	0		批量查询
玛卡中国	2	0	0	0	0	0	0	0	0	0	0	0	0	0	0		批量查询
玛卡真的管用吗	2	0	0	0	0	0	0	0	0	0	0	0	0	0	0		批量查询
玛卡片真的有效果吗	2	0	0	0	0	0	0	0	0	0	0	0	0	0	0		批量查询
活力达秘鲁进口玛卡	2	0	0	0	0	0	0	0	0	0	0	0	0	0	0		批量查询
秘鲁进口玛卡	2	0	0	0	0	0	0	0	0	0	0	0	0	0	0		批量查询
秘鲁进口天然玛卡	2	0	0	0	0	0	0	0	0	0	0	0	0	0	0		批量查询
天然玛卡价格	2	0	0	0	0	0	0	0	0	0	0	0	0	0	0		批量查询
玛卡 秘鲁	2	0	0	0	0	0	0	0	0	0	0	0	0	0	0		批量查询
黄金玛卡maca	2	0	0	0	0	0	0	0	0	0	0	0	0	0	0		批量查询
黄金玛卡价格	2	0	0	0	0	0	0	0	0	0	0	0	0	0	0		批量查询
拉摩力拉牌玛卡片	2	0	0	0	0	0	0	0	0	0	0	0	0	0	0		批量查询
中国玛卡	2	0	0	0	0	0	0	0	0	0	0	0	0	0	0		批量查询
玛卡对身体有害吗	2	0	0	0	0	0	0	0	0	0	0	0	0	0	0		批量查询
玛卡视频	2	0	0	0	0	0	0	0	0	0	0	0	0	0	0		批量查询
玛卡西童装	2	0	0	0	0	0	0	0	0	0	0	0	0	0	0		批量查询
玛卡骗局	2	0	0	0	0	0	0	0	0	0	0	0	0	0	0		批量查询
上海中智玛卡	2	0	0	0	0	0	0	0	0	0	0	0	0	0	0		批量查询
玛卡西尼怎么样	2	0	0	0	0	0	0	0	0	0	0	0	0	0	0		批量查询
玛卡效果好吗	2	0	0	0	0	0	0	0	0	0	0	0	0	0	0		批量查询
玛卡效果如何	2	0	0	0	0	0	0	0	0	0	0	0	0	0	0		批量查询
玛卡货到付款	2	0	0	0	0	0	0	0	0	0	0	0	0	0	0		批量查询
玛卡真假对比	2	0	0	0	0	0	0	0	0	0	0	0	0	0	0		批量查询
玛卡哪个品牌好	2	0	0	0	0	0	0	0	0	0	0	0	0	0	0		批量查询
黄金玛卡官网	2	0	0	0	0	0	0	0	0	0	0	0	0	0	0		批量查询
玛咖玛卡	1	0	0	0	0	0	0	0	0	0	0	0	0	0	0		批量查询
玛卡祛疤精华胶	1	0	0	0	0	0	0	0	0	0	0	0	0	0	0		批量查询
拉摩力牌玛卡片	1	0	0	0	0	0	0	0	0	0	0	0	0	0	0		批量查询
玛卡成分	1	0	0	0	0	0	0	0	0	0	0	0	0	0	0		批量查询
玛卡切片	1	0	0	0	0	0	0	0	0	0	0	0	0	0	0		批量查询
康美药业玛卡	1	0	0	0	0	0	0	0	0	0	0	0	0	0	0		批量查询
妈咪玛卡童装	1	0	0	0	0	0	0	0	0	0	0	0	0	0	0		批量查询
玛卡虫草王	1	0	0	0	0	0	0	0	0	0	0	0	0	0	0		批量查询
魔力玛卡	1	0	0	0	0	0	0	0	0	0	0	0	0	0	0		批量查询
拉摩力拉秘鲁玛卡	1	0	0	0	0	0	0	0	0	0	0	0	0	0	0		批量查询
秘鲁玛卡种子	1	0	0	0	0	0	0	0	0	0	0	0	0	0	0		批量查询
玛卡益康咀嚼片有效吗	1	0	0	0	0	0	0	0	0	0	0	0	0	0	0		批量查询
秘鲁玛卡粉	1	0	0	0	0	0	0	0	0	0	0	0	0	0	0		批量查询
正品玛卡哪里买	1	0	0	0	0	0	0	0	0	0	0	0	0	0	0		批量查询
如何买到正品玛卡	1	0	0	0	0	0	0	0	0	0	0	0	0	0	0		批量查询
marccasne玛卡西尼	1	0	0	0	0	0	0	0	0	0	0	0	0	0	0		批量查询
上海玛卡	1	0	0	0	0	0	0	0	0	0	0	0	0	0	0		批量查询
会泽玛卡	1	0	0	0	0	0	0	0	0	0	0	0	0	0	0		批量查询
紫色玛卡	1	0	0	0	0	0	0	0	0	0	0	0	0	0	0		批量查询
享硬玛卡片	1	0	0	0	0	0	0	0	0	0	0	0	0	0	0		批量查询
秘鲁玛卡正品	1	0	0	0	0	0	0	0	0	0	0	0	0	0	0		批量查询
玛卡片价格	1	0	0	0	0	0	0	0	0	0	0	0	0	0	0		批量查询
秘鲁玛卡有副作用吗	1	0	0	0	0	0	0	0	0	0	0	0	0	0	0		批量查询
花园宝宝玛卡巴卡	1	0	0	0	0	0	0	0	0	0	0	0	0	0	0		批量查询
诺奥 秘鲁玛卡	1	0	0	0	0	0	0	0	0	0	0	0	0	0	0		批量查询
壮阳玛卡	1	0	0	0	0	0	0	0	0	0	0	0	0	0	0		批量查询
玛卡真假识别	1	0	0	0	0	0	0	0	0	0	0	0	0	0	0		批量查询
玛卡片的副作用	1	0	0	0	0	0	0	0	0	0	0	0	0	0	0		批量查询
玛卡加工	1	0	0	0	0	0	0	0	0	0	0	0	0	0	0		批量查询
云南玛卡片	1	0	0	0	0	0	0	0	0	0	0	0	0	0	0		批量查询
倍斯万玛卡	1	0	0	0	0	0	0	0	0	0	0	0	0	0	0		批量查询
美国黄金玛卡maca	1	0	0	0	0	0	0	0	0	0	0	0	0	0	0		批量查询
伽玛卡兹鱼竿专卖	1	0	0	0	0	0	0	0	0	0	0	0	0	0	0		批量查询
活力达秘鲁进口玛卡精片怎么样	1	0	0	0	0	0	0	0	0	0	0	0	0	0	0		批量查询
玛卡 秘鲁原装	1	0	0	0	0	0	0	0	0	0	0	0	0	0	0		批量查询
速效玛卡	1	0	0	0	0	0	0	0	0	0	0	0	0	0	0		批量查询
玛卡效果好不好	1	0	0	0	0	0	0	0	0	0	0	0	0	0	0		批量查询
玛米玛卡童装加盟店	1	0	0	0	0	0	0	0	0	0	0	0	0	0	0		批量查询
玛卡泡水喝的功效	1	0	0	0	0	0	0	0	0	0	0	0	0	0	0		批量查询
秘鲁玛卡干果价格	1	0	0	0	0	0	0	0	0	0	0	0	0	0	0		批量查询
秘鲁玛卡功效	1	0	0	0	0	0	0	0	0	0	0	0	0	0	0		批量查询
玛卡威刚胶囊	1	0	0	0	0	0	0	0	0	0	0	0	0	0	0		批量查询
原装进口玛卡	1	0	0	0	0	0	0	0	0	0	0	0	0	0	0		批量查询
拉摩力拉玛卡	1	0	0	0	0	0	0	0	0	0	0	0	0	0	0		批量查询
女用玛卡	1	0	0	0	0	0	0	0	0	0	0	0	0	0	0		批量查询
秘鲁玛卡片maca	1	0	0	0	0	0	0	0	0	0	0	0	0	0	0		批量查询
秘鲁拉摩力拉玛卡	1	0	0	0	0	0	0	0	0	0	0	0	0	0	0		批量查询
玛卡怎么辨别真假	1	0	0	0	0	0	0	0	0	0	0	0	0	0	0		批量查询
玛卡的真假	1	0	0	0	0	0	0	0	0	0	0	0	0	0	0		批量查询
秘鲁玛卡胶囊效果好吗	1	0	0	0	0	0	0	0	0	0	0	0	0	0	0		批量查询
秘鲁玛卡胶囊官网	1	0	0	0	0	0	0	0	0	0	0	0	0	0	0		批量查询
玛卡益康咀嚼片副作用	1	0	0	0	0	0	0	0	0	0	0	0	0	0	0		批量查询
新鲜玛卡价格	1	0	0	0	0	0	0	0	0	0	0	0	0	0	0		批量查询
玛卡益康片一瓶多少粒	1	0	0	0	0	0	0	0	0	0	0	0	0	0	0		批量查询
秘鲁玛卡多少钱一瓶	1	0	0	0	0	0	0	0	0	0	0	0	0	0	0		批量查询
玛卡进口	1	0	0	0	0	0	0	0	0	0	0	0	0	0	0		批量查询
云南玛卡种植	1	0	0	0	0	0	0	0	0	0	0	0	0	0	0		批量查询
玛卡秘鲁玛卡	1	0	0	0	0	0	0	0	0	0	0	0	0	0	0		批量查询
玛卡是什么药	1	0	0	0	0	0	0	0	0	0	0	0	0	0	0		批量查询
玛卡粉价格	1	0	0	0	0	0	0	0	0	0	0	0	0	0	0		批量查询
玛卡巴卡之歌	1	0	0	0	0	0	0	0	0	0	0	0	0	0	0		批量查询
玛卡厂家	1	0	0	0	0	0	0	0	0	0	0	0	0	0	0		批量查询
拉摩力拉玛卡怎么样	1	0	0	0	0	0	0	0	0	0	0	0	0	0	0		批量查询
进口秘鲁玛卡	1	0	0	0	0	0	0	0	0	0	0	0	0	0	0		批量查询
玛卡饮料	1	0	0	0	0	0	0	0	0	0	0	0	0	0	0		批量查询
秘鲁玛卡正品官网	1	0	0	0	0	0	0	0	0	0	0	0	0	0	0		批量查询
玛卡药材	1	0	0	0	0	0	0	0	0	0	0	0	0	0	0		批量查询
玛卡胶囊官方网站	1	0	0	0	0	0	0	0	0	0	0	0	0	0	0		批量查询
玛卡玛嘉	1	0	0	0	0	0	0	0	0	0	0	0	0	0	0		批量查询
如何鉴别真假玛卡	1	0	0	0	0	0	0	0	0	0	0	0	0	0	0		批量查询
香格里拉玛卡	1	0	0	0	0	0	0	0	0	0	0	0	0	0	0		批量查询
玛卡哪有卖的	1	0	0	0	0	0	0	0	0	0	0	0	0	0	0		批量查询
美国爱司盟玛卡	0	0	0	0	0	0	0	0	0	0	0	0	0	0	0		批量查询
秘鲁玛卡浓缩片	0	0	0	0	0	0	0	0	0	0	0	0	0	0	0		批量查询
玛卡属于中药材么	0	0	0	0	0	0	0	0	0	0	0	0	0	0	0		批量查询
恕瑞玛卡	0	0	0	0	0	0	0	0	0	0	0	0	0	0	0		批量查询
怒瑞玛卡	0	0	0	0	0	0	0	0	0	0	0	0	0	0	0		批量查询
玛卡丽娜形体舞	0	0	0	0	0	0	0	0	0	0	0	0	0	0	0		批量查询
日本 玛卡精华片	0	0	0	0	0	0	0	0	0	0	0	0	0	0	0		批量查询
黑色玛卡干果	0	0	0	0	0	0	0	0	0	0	0	0	0	0	0		批量查询
黑色玛卡秘鲁干果	0	0	0	0	0	0	0	0	0	0	0	0	0	0	0		批量查询
黑色玛卡500克	0	0	0	0	0	0	0	0	0	0	0	0	0	0	0		批量查询
黑色玛卡中草药	0	0	0	0	0	0	0	0	0	0	0	0	0	0	0		批量查询
黑色玛卡干片	0	0	0	0	0	0	0	0	0	0	0	0	0	0	0		批量查询
黑色玛卡种子	0	0	0	0	0	0	0	0	0	0	0	0	0	0	0		批量查询
黑色玛卡秘鲁干果250	0	0	0	0	0	0	0	0	0	0	0	0	0	0	0		批量查询
丽江黑色玛卡干果	0	0	0	0	0	0	0	0	0	0	0	0	0	0	0		批量查询
丽江黑色玛卡干黑	0	0	0	0	0	0	0	0	0	0	0	0	0	0	0		批量查询
黑色紫色玛卡	0	0	0	0	0	0	0	0	0	0	0	0	0	0	0		批量查询
种玛卡适宜环境	0	0	0	0	0	0	0	0	0	0	0	0	0	0	0		批量查询
正品云南丽江黑玛卡	0	0	0	0	0	0	0	0	0	0	0	0	0	0	0		批量查询
玛卡炖鸡	0	0	0	0	0	0	0	0	0	0	0	0	0	0	0		批量查询
玛卡养生咖啡	0	0	0	0	0	0	0	0	0	0	0	0	0	0	0		批量查询
卡图巴与玛卡哪个好	0	0	0	0	0	0	0	0	0	0	0	0	0	0	0		批量查询
中国玛卡哪些地方种植	0	0	0	0	0	0	0	0	0	0	0	0	0	0	0		批量查询
玛卡益康好不好	0	0	0	0	0	0	0	0	0	0	0	0	0	0	0		批量查询
玛卡是不是恰玛古	0	0	0	0	0	0	0	0	0	0	0	0	0	0	0		批量查询
滁州玛卡玛嘉团购	0	0	0	0	0	0	0	0	0	0	0	0	0	0	0		批量查询
玛卡多长时间起效	0	0	0	0	0	0	0	0	0	0	0	0	0	0	0		批量查询
玛卡泡酒多长时间有效	0	0	0	0	0	0	0	0	0	0	0	0	0	0	0		批量查询
玛卡泡酒多长时间能喝	0	0	0	0	0	0	0	0	0	0	0	0	0	0	0		批量查询
玛卡多长时间见效果	0	0	0	0	0	0	0	0	0	0	0	0	0	0	0		批量查询
玛卡一般要吃多长时间	0	0	0	0	0	0	0	0	0	0	0	0	0	0	0		批量查询
玛卡什么时间吃最好	0	0	0	0	0	0	0	0	0	0	0	0	0	0	0		批量查询
拉魔力玛卡有效果吗	0	0	0	0	0	0	0	0	0	0	0	0	0	0	0		批量查询
中国有种植玛卡的吗	0	0	0	0	0	0	0	0	0	0	0	0	0	0	0		批量查询
玛卡在中国能种植吗	0	0	0	0	0	0	0	0	0	0	0	0	0	0	0		批量查询
bakmk芭卡玛卡	0	0	0	0	0	0	0	0	0	0	0	0	0	0	0		批量查询
芭卡玛卡	0	0	0	0	0	0	0	0	0	0	0	0	0	0	0		批量查询
电视上说的玛卡	0	0	0	0	0	0	0	0	0	0	0	0	0	0	0		批量查询
玛卡上央视视频	0	0	0	0	0	0	0	0	0	0	0	0	0	0	0		批量查询
淘宝网上买的玛卡	0	0	0	0	0	0	0	0	0	0	0	0	0	0	0		批量查询
玛卡网上卖的是真的么	0	0	0	0	0	0	0	0	0	0	0	0	0	0	0		批量查询
云南玛卡哪家好	0	0	0	0	0	0	0	0	0	0	0	0	0	0	0		批量查询
玛卡 谁家的好	0	0	0	0	0	0	0	0	0	0	0	0	0	0	0		批量查询
玛卡哪家好	0	0	0	0	0	0	0	0	0	0	0	0	0	0	0		批量查询
天猫哪家卖玛卡好	0	0	0	0	0	0	0	0	0	0	0	0	0	0	0		批量查询
玛卡莱娜舞蹈视频	0	0	0	0	0	0	0	0	0	0	0	0	0	0	0		批量查询
玛卡莱娜mp3	0	0	0	0	0	0	0	0	0	0	0	0	0	0	0		批量查询
丽彩芳姿女士玛卡片	0	0	0	0	0	0	0	0	0	0	0	0	0	0	0		批量查询
玛卡丽娜舞曲	0	0	0	0	0	0	0	0	0	0	0	0	0	0	0		批量查询
玛卡丽娜 游戏	0	0	0	0	0	0	0	0	0	0	0	0	0	0	0		批量查询
玛卡丽娜mv	0	0	0	0	0	0	0	0	0	0	0	0	0	0	0		批量查询
玛卡丽娜 英文	0	0	0	0	0	0	0	0	0	0	0	0	0	0	0		批量查询
玛卡丽娜 海龟先生	0	0	0	0	0	0	0	0	0	0	0	0	0	0	0		批量查询
黑玛卡粉代购	0	0	0	0	0	0	0	0	0	0	0	0	0	0	0		批量查询
黑玛卡精粉	0	0	0	0	0	0	0	0	0	0	0	0	0	0	0		批量查询
玛卡中国哪里种植	0	0	0	0	0	0	0	0	0	0	0	0	0	0	0		批量查询
丽江黑玛卡玛咖干片	0	0	0	0	0	0	0	0	0	0	0	0	0	0	0		批量查询
丽江黑玛卡干片	0	0	0	0	0	0	0	0	0	0	0	0	0	0	0		批量查询
丽江黑玛卡500g	0	0	0	0	0	0	0	0	0	0	0	0	0	0	0		批量查询
中国哪里可以种植玛卡	0	0	0	0	0	0	0	0	0	0	0	0	0	0	0		批量查询
北京玛卡	0	0	0	0	0	0	0	0	0	0	0	0	0	0	0		批量查询
养生之道 玛卡的药效	0	0	0	0	0	0	0	0	0	0	0	0	0	0	0		批量查询
玛卡虫草	0	0	0	0	0	0	0	0	0	0	0	0	0	0	0		批量查询
玛卡那个网站是真的	0	0	0	0	0	0	0	0	0	0	0	0	0	0	0		批量查询
玛卡真网站	0	0	0	0	0	0	0	0	0	0	0	0	0	0	0		批量查询
网上哪家卖玛卡是真的	0	0	0	0	0	0	0	0	0	0	0	0	0	0	0		批量查询
网上卖的玛卡是真的吗	0	0	0	0	0	0	0	0	0	0	0	0	0	0	0		批量查询
中国卖的玛卡是真的吗	0	0	0	0	0	0	0	0	0	0	0	0	0	0	0		批量查询
玛卡介绍	0	0	0	0	0	0	0	0	0	0	0	0	0	0	0		批量查询
姿一堂玛卡黄精片	0	0	0	0	0	0	0	0	0	0	0	0	0	0	0		批量查询
中国玛卡哪有种植	0	0	0	0	0	0	0	0	0	0	0	0	0	0	0		批量查询
德国黑金刚玛卡用阳痿阴茎增大延时	0	0	0	0	0	0	0	0	0	0	0	0	0	0	0		批量查询
哪有卖玛卡种子	0	0	0	0	0	0	0	0	0	0	0	0	0	0	0		批量查询
重庆哪里有玛卡种子卖	0	0	0	0	0	0	0	0	0	0	0	0	0	0	0		批量查询
秘鲁玛卡长春销售	0	0	0	0	0	0	0	0	0	0	0	0	0	0	0		批量查询
丽江玛卡销售加盟代理	0	0	0	0	0	0	0	0	0	0	0	0	0	0	0		批量查询
伽玛卡兹紬18尺	0	0	0	0	0	0	0	0	0	0	0	0	0	0	0		批量查询
玛卡种子销售	0	0	0	0	0	0	0	0	0	0	0	0	0	0	0		批量查询
玛卡重庆销售	0	0	0	0	0	0	0	0	0	0	0	0	0	0	0		批量查询
谁对玛卡销售中心了解	0	0	0	0	0	0	0	0	0	0	0	0	0	0	0		批量查询
天津玛卡销售点	0	0	0	0	0	0	0	0	0	0	0	0	0	0	0		批量查询
秘鲁玛卡宜宾销售点	0	0	0	0	0	0	0	0	0	0	0	0	0	0	0		批量查询
玛卡销售点	0	0	0	0	0	0	0	0	0	0	0	0	0	0	0		批量查询
哪些人不能吃玛卡	0	0	0	0	0	0	0	0	0	0	0	0	0	0	0		批量查询
玛卡女人能吃?免费	0	0	0	0	0	0	0	0	0	0	0	0	0	0	0		批量查询
北京市哪家药店有玛卡	0	0	0	0	0	0	0	0	0	0	0	0	0	0	0		批量查询
沈阳哪里有卖玛卡的	0	0	0	0	0	0	0	0	0	0	0	0	0	0	0		批量查询
沈阳那有卖玛卡的	0	0	0	0	0	0	0	0	0	0	0	0	0	0	0		批量查询
沈阳哪有卖玛卡的	0	0	0	0	0	0	0	0	0	0	0	0	0	0	0		批量查询
沈阳玛卡	0	0	0	0	0	0	0	0	0	0	0	0	0	0	0		批量查询
沈阳药店 玛卡	0	0	0	0	0	0	0	0	0	0	0	0	0	0	0		批量查询
沈阳销售玛卡	0	0	0	0	0	0	0	0	0	0	0	0	0	0	0		批量查询
上海玛卡何处有售	0	0	0	0	0	0	0	0	0	0	0	0	0	0	0		批量查询
中智玛卡经销商	0	0	0	0	0	0	0	0	0	0	0	0	0	0	0		批量查询
中智玛卡代理商	0	0	0	0	0	0	0	0	0	0	0	0	0	0	0		批量查询
玛卡正品 maca玛咖	0	0	0	0	0	0	0	0	0	0	0	0	0	0	0		批量查询
玛米玛卡儿童服装	0	0	0	0	0	0	0	0	0	0	0	0	0	0	0		批量查询
式玛卡龙油漆价格	0	0	0	0	0	0	0	0	0	0	0	0	0	0	0		批量查询
玛卡秘鲁增大	0	0	0	0	0	0	0	0	0	0	0	0	0	0	0		批量查询
玛卡 保健品 延时 增大	0	0	0	0	0	0	0	0	0	0	0	0	0	0	0		批量查询
增大延时 玛卡	0	0	0	0	0	0	0	0	0	0	0	0	0	0	0		批量查询
正品伟延时增大玛卡	0	0	0	0	0	0	0	0	0	0	0	0	0	0	0		批量查询
玛卡秘鲁延时增大	0	0	0	0	0	0	0	0	0	0	0	0	0	0	0		批量查询
北京哪有买玛卡胶囊的	0	0	0	0	0	0	0	0	0	0	0	0	0	0	0		批量查询
上海哪里有玛卡买	0	0	0	0	0	0	0	0	0	0	0	0	0	0	0		批量查询
廊坊那里买玛卡药	0	0	0	0	0	0	0	0	0	0	0	0	0	0	0		批量查询
玛卡速效药	0	0	0	0	0	0	0	0	0	0	0	0	0	0	0		批量查询
有收购玛卡的吗	0	0	0	0	0	0	0	0	0	0	0	0	0	0	0		批量查询
伽玛卡兹紬 13尺	0	0	0	0	0	0	0	0	0	0	0	0	0	0	0		批量查询
伽玛卡兹一慧 15尺	0	0	0	0	0	0	0	0	0	0	0	0	0	0	0		批量查询
伽玛卡兹一彗15尺	0	0	0	0	0	0	0	0	0	0	0	0	0	0	0		批量查询
进口-玛卡种子	0	0	0	0	0	0	0	0	0	0	0	0	0	0	0		批量查询
冻干玛卡果	0	0	0	0	0	0	0	0	0	0	0	0	0	0	0		批量查询
玛卡性味	0	0	0	0	0	0	0	0	0	0	0	0	0	0	0		批量查询
补肾玛卡片有用吗	0	0	0	0	0	0	0	0	0	0	0	0	0	0	0		批量查询
糊化玛卡粉	0	0	0	0	0	0	0	0	0	0	0	0	0	0	0		批量查询
糊化玛卡	0	0	0	0	0	0	0	0	0	0	0	0	0	0	0		批量查询
糊化maca玛卡粉250克	0	0	0	0	0	0	0	0	0	0	0	0	0	0	0		批量查询
斯旺森玛咖maca玛卡	0	0	0	0	0	0	0	0	0	0	0	0	0	0	0		批量查询
鲜玛卡能泡酒吗	0	0	0	0	0	0	0	0	0	0	0	0	0	0	0		批量查询
玛卡粉可以泡酒吗	0	0	0	0	0	0	0	0	0	0	0	0	0	0	0		批量查询
玛卡粉能泡酒吗	0	0	0	0	0	0	0	0	0	0	0	0	0	0	0		批量查询
玛卡枸杞泡酒怎么样	0	0	0	0	0	0	0	0	0	0	0	0	0	0	0		批量查询
玛卡果泡酒有效果吗	0	0	0	0	0	0	0	0	0	0	0	0	0	0	0		批量查询
玛卡秘鲁正品蛮哥	0	0	0	0	0	0	0	0	0	0	0	0	0	0	0		批量查询
秘鲁玛卡进口蛮哥	0	0	0	0	0	0	0	0	0	0	0	0	0	0	0		批量查询
maca 玛卡干果	0	0	0	0	0	0	0	0	0	0	0	0	0	0	0		批量查询
玛卡之家是正规的吗	0	0	0	0	0	0	0	0	0	0	0	0	0	0	0		批量查询
玛卡之家macazjcom	0	0	0	0	0	0	0	0	0	0	0	0	0	0	0		批量查询
玛卡之家的电话	0	0	0	0	0	0	0	0	0	0	0	0	0	0	0		批量查询
玛卡之家怎么样	0	0	0	0	0	0	0	0	0	0	0	0	0	0	0		批量查询
玛卡有多少家经销商	0	0	0	0	0	0	0	0	0	0	0	0	0	0	0		批量查询
玛卡片的食用方法	0	0	0	0	0	0	0	0	0	0	0	0	0	0	0		批量查询
丽江高原玛卡干果	0	0	0	0	0	0	0	0	0	0	0	0	0	0	0		批量查询
云南玛卡批发价是多少	0	0	0	0	0	0	0	0	0	0	0	0	0	0	0		批量查询
2h2d玛卡	0	0	0	0	0	0	0	0	0	0	0	0	0	0	0		批量查询
2h2d黑玛卡	0	0	0	0	0	0	0	0	0	0	0	0	0	0	0		批量查询
2h2d黑玛卡片	0	0	0	0	0	0	0	0	0	0	0	0	0	0	0		批量查询
男士玛卡	0	0	0	0	0	0	0	0	0	0	0	0	0	0	0		批量查询
玛卡精华片	0	0	0	0	0	0	0	0	0	0	0	0	0	0	0		批量查询
玛卡破壁精粉	0	0	0	0	0	0	0	0	0	0	0	0	0	0	0		批量查询
泉州玛米玛卡工厂店	0	0	0	0	0	0	0	0	0	0	0	0	0	0	0		批量查询
上海式玛卡龙涂料	0	0	0	0	0	0	0	0	0	0	0	0	0	0	0		批量查询
莱茵玛卡龙甜品	0	0	0	0	0	0	0	0	0	0	0	0	0	0	0		批量查询
莱因玛卡龙	0	0	0	0	0	0	0	0	0	0	0	0	0	0	0		批量查询
玛卡龙 酒 价格	0	0	0	0	0	0	0	0	0	0	0	0	0	0	0		批量查询
玛卡龙加盟	0	0	0	0	0	0	0	0	0	0	0	0	0	0	0		批量查询
now foods玛卡maca胶囊	0	0	0	0	0	0	0	0	0	0	0	0	0	0	0		批量查询
玛卡加盟代理	0	0	0	0	0	0	0	0	0	0	0	0	0	0	0		批量查询
玛卡代理条件	0	0	0	0	0	0	0	0	0	0	0	0	0	0	0		批量查询
玛卡南宁代理	0	0	0	0	0	0	0	0	0	0	0	0	0	0	0		批量查询
黑秘鲁 玛卡maca 代购	0	0	0	0	0	0	0	0	0	0	0	0	0	0	0		批量查询
天然玛卡有假的吗	0	0	0	0	0	0	0	0	0	0	0	0	0	0	0		批量查询
云南玛卡营养成分分析	0	0	0	0	0	0	0	0	0	0	0	0	0	0	0		批量查询
玛卡营养成分	0	0	0	0	0	0	0	0	0	0	0	0	0	0	0		批量查询
玛卡的营养成份	0	0	0	0	0	0	0	0	0	0	0	0	0	0	0		批量查询
玛卡秘鲁 云南	0	0	0	0	0	0	0	0	0	0	0	0	0	0	0		批量查询
云南黑玛咖秘鲁玛卡	0	0	0	0	0	0	0	0	0	0	0	0	0	0	0		批量查询
玛卡炖什么	0	0	0	0	0	0	0	0	0	0	0	0	0	0	0		批量查询
玛卡炖食方法	0	0	0	0	0	0	0	0	0	0	0	0	0	0	0		批量查询
玛卡可以炖来吃吗	0	0	0	0	0	0	0	0	0	0	0	0	0	0	0		批量查询
炖玛卡	0	0	0	0	0	0	0	0	0	0	0	0	0	0	0		批量查询
德玛卡古	0	0	0	0	0	0	0	0	0	0	0	0	0	0	0		批量查询
雪鼎玛卡直销中心	0	0	0	0	0	0	0	0	0	0	0	0	0	0	0		批量查询
黑玛卡和黄玛卡	0	0	0	0	0	0	0	0	0	0	0	0	0	0	0		批量查询
什么样的人不能吃玛卡	0	0	0	0	0	0	0	0	0	0	0	0	0	0	0		批量查询
胃不好的人能吃玛卡吗	0	0	0	0	0	0	0	0	0	0	0	0	0	0	0		批量查询
云南天根玛卡产业有限公司	0	0	0	0	0	0	0	0	0	0	0	0	0	0	0		批量查询
玛卡片北京哪家药店卖	0	0	0	0	0	0	0	0	0	0	0	0	0	0	0		批量查询
女用玛卡片	0	0	0	0	0	0	0	0	0	0	0	0	0	0	0		批量查询
女用玛卡精片	0	0	0	0	0	0	0	0	0	0	0	0	0	0	0		批量查询
女用玛卡秘鲁正品	0	0	0	0	0	0	0	0	0	0	0	0	0	0	0		批量查询
女用秘鲁玛卡	0	0	0	0	0	0	0	0	0	0	0	0	0	0	0		批量查询
玛卡片真假	0	0	0	0	0	0	0	0	0	0	0	0	0	0	0		批量查询
玛卡片的真假辩别	0	0	0	0	0	0	0	0	0	0	0	0	0	0	0		批量查询
玛卡片真假难辨	0	0	0	0	0	0	0	0	0	0	0	0	0	0	0		批量查询
云南玛咖精片黑玛卡	0	0	0	0	0	0	0	0	0	0	0	0	0	0	0		批量查询
云南新鲜黑玛卡	0	0	0	0	0	0	0	0	0	0	0	0	0	0	0		批量查询
迈卡牌玛卡蛹虫草片	0	0	0	0	0	0	0	0	0	0	0	0	0	0	0		批量查询
迈卡牌玛卡益康精片	0	0	0	0	0	0	0	0	0	0	0	0	0	0	0		批量查询
迈卡牌玛卡片	0	0	0	0	0	0	0	0	0	0	0	0	0	0	0		批量查询
云南迈卡牌玛卡正品	0	0	0	0	0	0	0	0	0	0	0	0	0	0	0		批量查询
丽江玛卡生物有限公司	0	0	0	0	0	0	0	0	0	0	0	0	0	0	0		批量查询
玛卡能增大吗	0	0	0	0	0	0	0	0	0	0	0	0	0	0	0		批量查询
玛卡能增大	0	0	0	0	0	0	0	0	0	0	0	0	0	0	0		批量查询
玛卡的功能	0	0	0	0	0	0	0	0	0	0	0	0	0	0	0		批量查询
享硬玛卡怎么样	0	0	0	0	0	0	0	0	0	0	0	0	0	0	0		批量查询
玛卡中国官网	0	0	0	0	0	0	0	0	0	0	0	0	0	0	0		批量查询
野象玛卡露酒	0	0	0	0	0	0	0	0	0	0	0	0	0	0	0		批量查询
玛卡植物来源	0	0	0	0	0	0	0	0	0	0	0	0	0	0	0		批量查询
2014黑玛卡干片正品	0	0	0	0	0	0	0	0	0	0	0	0	0	0	0		批量查询
玛卡应如何食用才好	0	0	0	0	0	0	0	0	0	0	0	0	0	0	0		批量查询
云南玛卡如何食用	0	0	0	0	0	0	0	0	0	0	0	0	0	0	0		批量查询
玛卡 骗局	0	0	0	0	0	0	0	0	0	0	0	0	0	0	0		批量查询
活力达秘鲁进口玛卡精片90片\\\/瓶	0	0	0	0	0	0	0	0	0	0	0	0	0	0	0		批量查询
玛卡和枸杞泡酒行吗	0	0	0	0	0	0	0	0	0	0	0	0	0	0	0		批量查询
玛卡能和松露泡酒吗	0	0	0	0	0	0	0	0	0	0	0	0	0	0	0		批量查询
林芝玛卡农场	0	0	0	0	0	0	0	0	0	0	0	0	0	0	0		批量查询
玛卡庄园	0	0	0	0	0	0	0	0	0	0	0	0	0	0	0		批量查询
金色庄园玛卡红	0	0	0	0	0	0	0	0	0	0	0	0	0	0	0		批量查询
云南玛卡专营店 店铺	0	0	0	0	0	0	0	0	0	0	0	0	0	0	0		批量查询
昆明玛卡专营店	0	0	0	0	0	0	0	0	0	0	0	0	0	0	0		批量查询
玛卡酒价格	0	0	0	0	0	0	0	0	0	0	0	0	0	0	0		批量查询
玛卡根男士洗面奶	0	0	0	0	0	0	0	0	0	0	0	0	0	0	0		批量查询
玛卡根胶囊	0	0	0	0	0	0	0	0	0	0	0	0	0	0	0		批量查询
重庆玛卡西尼	0	0	0	0	0	0	0	0	0	0	0	0	0	0	0		批量查询
活性破壁黄金玛卡精片	0	0	0	0	0	0	0	0	0	0	0	0	0	0	0		批量查询
女性玛卡胶囊	0	0	0	0	0	0	0	0	0	0	0	0	0	0	0		批量查询
美国金玛卡	0	0	0	0	0	0	0	0	0	0	0	0	0	0	0		批量查询
玛卡和黑金那个好	0	0	0	0	0	0	0	0	0	0	0	0	0	0	0		批量查询
玛咖精片玛卡女性用	0	0	0	0	0	0	0	0	0	0	0	0	0	0	0		批量查询
纯天然秘鲁玛卡粉	0	0	0	0	0	0	0	0	0	0	0	0	0	0	0		批量查询
纯天然秘鲁玛卡	0	0	0	0	0	0	0	0	0	0	0	0	0	0	0		批量查询
玛咪玛卡童装	0	0	0	0	0	0	0	0	0	0	0	0	0	0	0		批量查询
童装妈咪玛卡批发	0	0	0	0	0	0	0	0	0	0	0	0	0	0	0		批量查询
玛卡one童装	0	0	0	0	0	0	0	0	0	0	0	0	0	0	0		批量查询
妈咪玛卡时尚炫彩童装毛片毛线	0	0	0	0	0	0	0	0	0	0	0	0	0	0	0		批量查询
码米玛卡童装	0	0	0	0	0	0	0	0	0	0	0	0	0	0	0		批量查询
天津卫视 肾虚 玛卡	0	0	0	0	0	0	0	0	0	0	0	0	0	0	0		批量查询
玛卡对肾虚有什么作用	0	0	0	0	0	0	0	0	0	0	0	0	0	0	0		批量查询
玛卡治肾虚吗	0	0	0	0	0	0	0	0	0	0	0	0	0	0	0		批量查询
玛卡 肾虚	0	0	0	0	0	0	0	0	0	0	0	0	0	0	0		批量查询
玛卡对肾虚有用吗	0	0	0	0	0	0	0	0	0	0	0	0	0	0	0		批量查询
女性玛卡能补肾虚吗	0	0	0	0	0	0	0	0	0	0	0	0	0	0	0		批量查询
玛卡治疗肾虚有用么	0	0	0	0	0	0	0	0	0	0	0	0	0	0	0		批量查询
女人肾虚能吃玛卡吗	0	0	0	0	0	0	0	0	0	0	0	0	0	0	0		批量查询
玛卡对肾虚有效果吗	0	0	0	0	0	0	0	0	0	0	0	0	0	0	0		批量查询
玛卡怎么分辨真假	0	0	0	0	0	0	0	0	0	0	0	0	0	0	0		批量查询
黄玛卡片 紫玛卡片	0	0	0	0	0	0	0	0	0	0	0	0	0	0	0		批量查询
红顺堂 玛卡	0	0	0	0	0	0	0	0	0	0	0	0	0	0	0		批量查询
妈咪玛卡炫彩童装线	0	0	0	0	0	0	0	0	0	0	0	0	0	0	0		批量查询
玛卡 正品 原装进口	0	0	0	0	0	0	0	0	0	0	0	0	0	0	0		批量查询
玛卡童装男	0	0	0	0	0	0	0	0	0	0	0	0	0	0	0		批量查询
妈咪玛卡童装线	0	0	0	0	0	0	0	0	0	0	0	0	0	0	0		批量查询
药材种植网玛卡种子	0	0	0	0	0	0	0	0	0	0	0	0	0	0	0		批量查询
恩百玛卡片	0	0	0	0	0	0	0	0	0	0	0	0	0	0	0		批量查询
恩百玛卡片怎么样	0	0	0	0	0	0	0	0	0	0	0	0	0	0	0		批量查询
lol恕瑞玛卡	0	0	0	0	0	0	0	0	0	0	0	0	0	0	0		批量查询
英雄联盟恕瑞玛卡	0	0	0	0	0	0	0	0	0	0	0	0	0	0	0		批量查询
人女士玛卡	0	0	0	0	0	0	0	0	0	0	0	0	0	0	0		批量查询
女士玛卡80片	0	0	0	0	0	0	0	0	0	0	0	0	0	0	0		批量查询
女士玛卡40片	0	0	0	0	0	0	0	0	0	0	0	0	0	0	0		批量查询
玛卡有效果没有	0	0	0	0	0	0	0	0	0	0	0	0	0	0	0		批量查询
玛卡没有哪吗神	0	0	0	0	0	0	0	0	0	0	0	0	0	0	0		批量查询
玛卡没有用	0	0	0	0	0	0	0	0	0	0	0	0	0	0	0		批量查询
玛卡炖汤	0	0	0	0	0	0	0	0	0	0	0	0	0	0	0		批量查询
玛卡产业发展研究	0	0	0	0	0	0	0	0	0	0	0	0	0	0	0		批量查询
秘鲁玛卡产业	0	0	0	0	0	0	0	0	0	0	0	0	0	0	0		批量查询
发展玛卡产业的探讨	0	0	0	0	0	0	0	0	0	0	0	0	0	0	0		批量查询
玛卡与袋鼠精哪个更好	0	0	0	0	0	0	0	0	0	0	0	0	0	0	0		批量查询
鲜玛卡怎么服用更好	0	0	0	0	0	0	0	0	0	0	0	0	0	0	0		批量查询
玛卡确实好用吗	0	0	0	0	0	0	0	0	0	0	0	0	0	0	0		批量查询
中智健康玛卡	0	0	0	0	0	0	0	0	0	0	0	0	0	0	0		批量查询
姿一堂玛卡	0	0	0	0	0	0	0	0	0	0	0	0	0	0	0		批量查询
红顺堂玛卡	0	0	0	0	0	0	0	0	0	0	0	0	0	0	0		批量查询
红顺堂玛卡精片	0	0	0	0	0	0	0	0	0	0	0	0	0	0	0		批量查询
红顺堂玛卡玛咖精片	0	0	0	0	0	0	0	0	0	0	0	0	0	0	0		批量查询
秘鲁玛卡官网315认证	0	0	0	0	0	0	0	0	0	0	0	0	0	0	0		批量查询
玛卡的权威认证	0	0	0	0	0	0	0	0	0	0	0	0	0	0	0		批量查询
中智i玛卡	0	0	0	0	0	0	0	0	0	0	0	0	0	0	0		批量查询
拉魔力玛卡片	0	0	0	0	0	0	0	0	0	0	0	0	0	0	0		批量查询
芭卡玛卡百度百科	0	0	0	0	0	0	0	0	0	0	0	0	0	0	0		批量查询
玛卡药材怎么吃好	0	0	0	0	0	0	0	0	0	0	0	0	0	0	0		批量查询
高品质玛卡的味道	0	0	0	0	0	0	0	0	0	0	0	0	0	0	0		批量查询
新鲜玛卡的味道	0	0	0	0	0	0	0	0	0	0	0	0	0	0	0		批量查询
蔚达男士玛卡	0	0	0	0	0	0	0	0	0	0	0	0	0	0	0		批量查询
玛卡配什么泡酒最好	0	0	0	0	0	0	0	0	0	0	0	0	0	0	0		批量查询
女士玛卡秘鲁正品	0	0	0	0	0	0	0	0	0	0	0	0	0	0	0		批量查询
女士玛卡精片	0	0	0	0	0	0	0	0	0	0	0	0	0	0	0		批量查询
秘鲁正品女士用玛卡	0	0	0	0	0	0	0	0	0	0	0	0	0	0	0		批量查询
女士 玛卡 补肾	0	0	0	0	0	0	0	0	0	0	0	0	0	0	0		批量查询
玛卡女士凝露	0	0	0	0	0	0	0	0	0	0	0	0	0	0	0		批量查询
玛卡药多少钱	0	0	0	0	0	0	0	0	0	0	0	0	0	0	0		批量查询
丽彩芳姿丽人玛卡80	0	0	0	0	0	0	0	0	0	0	0	0	0	0	0		批量查询
玛卡 丽彩芳姿	0	0	0	0	0	0	0	0	0	0	0	0	0	0	0		批量查询
进口玛卡品牌	0	0	0	0	0	0	0	0	0	0	0	0	0	0	0		批量查询
勃咔玛咖玛卡	0	0	0	0	0	0	0	0	0	0	0	0	0	0	0		批量查询
玛咖玛卡复合胶囊	0	0	0	0	0	0	0	0	0	0	0	0	0	0	0		批量查询
北京玛卡专卖	0	0	0	0	0	0	0	0	0	0	0	0	0	0	0		批量查询
lvci玛卡虫草	0	0	0	0	0	0	0	0	0	0	0	0	0	0	0		批量查询
玛卡颜色与品质	0	0	0	0	0	0	0	0	0	0	0	0	0	0	0		批量查询
什么颜色玛卡最好	0	0	0	0	0	0	0	0	0	0	0	0	0	0	0		批量查询
玛卡有分颜色吗	0	0	0	0	0	0	0	0	0	0	0	0	0	0	0		批量查询
玛卡泡酒是什么颜色	0	0	0	0	0	0	0	0	0	0	0	0	0	0	0		批量查询
玛卡皇帝伦	0	0	0	0	0	0	0	0	0	0	0	0	0	0	0		批量查询
三得利玛卡	0	0	0	0	0	0	0	0	0	0	0	0	0	0	0		批量查询
玛卡玛嘉西点烘焙工坊	0	0	0	0	0	0	0	0	0	0	0	0	0	0	0		批量查询
玛卡秘鲁正品 中智	0	0	0	0	0	0	0	0	0	0	0	0	0	0	0		批量查询
广东玛卡	0	0	0	0	0	0	0	0	0	0	0	0	0	0	0		批量查询
昭通市昭阳区美宏玛卡种植专业合作社	0	0	0	0	0	0	0	0	0	0	0	0	0	0	0		批量查询
玛卡重庆	0	0	0	0	0	0	0	0	0	0	0	0	0	0	0		批量查询
轩庆玛卡片有没有用	0	0	0	0	0	0	0	0	0	0	0	0	0	0	0		批量查询
轩庆生物玛卡片	0	0	0	0	0	0	0	0	0	0	0	0	0	0	0		批量查询
玛卡片昆明销售部	0	0	0	0	0	0	0	0	0	0	0	0	0	0	0		批量查询
拉摩力拉 玛卡片	0	0	0	0	0	0	0	0	0	0	0	0	0	0	0		批量查询
拉摩力拉 玛卡 60	0	0	0	0	0	0	0	0	0	0	0	0	0	0	0		批量查询
拉摩力拉 玛卡片 60片	0	0	0	0	0	0	0	0	0	0	0	0	0	0	0		批量查询
拉摩力拉 玛卡片 60	0	0	0	0	0	0	0	0	0	0	0	0	0	0	0		批量查询
成都什么地方可买玛卡	0	0	0	0	0	0	0	0	0	0	0	0	0	0	0		批量查询
丽江玛卡成都销售公司	0	0	0	0	0	0	0	0	0	0	0	0	0	0	0		批量查询
成都玛卡帝亚	0	0	0	0	0	0	0	0	0	0	0	0	0	0	0		批量查询
成都有卖玛卡的药店吗	0	0	0	0	0	0	0	0	0	0	0	0	0	0	0		批量查询
成都哪里有玛卡卖	0	0	0	0	0	0	0	0	0	0	0	0	0	0	0		批量查询
成都有卖玛卡的吗	0	0	0	0	0	0	0	0	0	0	0	0	0	0	0		批量查询
人不能吃玛卡	0	0	0	0	0	0	0	0	0	0	0	0	0	0	0		批量查询
玛卡能让女人	0	0	0	0	0	0	0	0	0	0	0	0	0	0	0		批量查询
喀什是否也出产玛卡	0	0	0	0	0	0	0	0	0	0	0	0	0	0	0		批量查询
喀什 玛卡	0	0	0	0	0	0	0	0	0	0	0	0	0	0	0		批量查询
玛卡养生	0	0	0	0	0	0	0	0	0	0	0	0	0	0	0		批量查询
陈维龄推荐玛卡养生	0	0	0	0	0	0	0	0	0	0	0	0	0	0	0		批量查询
养生保健玛卡	0	0	0	0	0	0	0	0	0	0	0	0	0	0	0		批量查询
泸州老窖玛卡养生酒	0	0	0	0	0	0	0	0	0	0	0	0	0	0	0		批量查询
关于养生玛卡的项目	0	0	0	0	0	0	0	0	0	0	0	0	0	0	0		批量查询
古方养生玛卡	0	0	0	0	0	0	0	0	0	0	0	0	0	0	0		批量查询
混沌之奥兹玛卡片	0	0	0	0	0	0	0	0	0	0	0	0	0	0	0		批量查询
dnf混沌之奥兹玛卡片	0	0	0	0	0	0	0	0	0	0	0	0	0	0	0		批量查询
混沌之奥兹玛卡片东一	0	0	0	0	0	0	0	0	0	0	0	0	0	0	0		批量查询
拉摩力拉玛卡 假药	0	0	0	0	0	0	0	0	0	0	0	0	0	0	0		批量查询
拉摩拉多牌玛卡片	0	0	0	0	0	0	0	0	0	0	0	0	0	0	0		批量查询
聚之爱牌玛卡片	0	0	0	0	0	0	0	0	0	0	0	0	0	0	0		批量查询
哪个牌子的玛卡片好	0	0	0	0	0	0	0	0	0	0	0	0	0	0	0		批量查询
北京哪里能买到玛卡片	0	0	0	0	0	0	0	0	0	0	0	0	0	0	0		批量查询
国产玛卡品牌	0	0	0	0	0	0	0	0	0	0	0	0	0	0	0		批量查询
什么牌子的玛卡片好	0	0	0	0	0	0	0	0	0	0	0	0	0	0	0		批量查询
玛卡片 牌子 好	0	0	0	0	0	0	0	0	0	0	0	0	0	0	0		批量查询
玛卡片好吗	0	0	0	0	0	0	0	0	0	0	0	0	0	0	0		批量查询
玛卡片哪种好	0	0	0	0	0	0	0	0	0	0	0	0	0	0	0		批量查询
网上卖的玛卡片哪的好	0	0	0	0	0	0	0	0	0	0	0	0	0	0	0		批量查询
木氏玛卡片	0	0	0	0	0	0	0	0	0	0	0	0	0	0	0		批量查询
松古树美黑玛卡80片	0	0	0	0	0	0	0	0	0	0	0	0	0	0	0		批量查询
佳莱福玛卡	0	0	0	0	0	0	0	0	0	0	0	0	0	0	0		批量查询
福源玛卡	0	0	0	0	0	0	0	0	0	0	0	0	0	0	0		批量查询
黒\玛卡	0	0	0	0	0	0	0	0	0	0	0	0	0	0	0		批量查询
正品丽江玛卡	0	0	0	0	0	0	0	0	0	0	0	0	0	0	0		批量查询
武汉玛卡益康	0	0	0	0	0	0	0	0	0	0	0	0	0	0	0		批量查询
三和 玛卡	0	0	0	0	0	0	0	0	0	0	0	0	0	0	0		批量查询
武汉买玛卡	0	0	0	0	0	0	0	0	0	0	0	0	0	0	0		批量查询
香港代购 秘鲁玛卡	0	0	0	0	0	0	0	0	0	0	0	0	0	0	0		批量查询
玛卡中国授权代理商	0	0	0	0	0	0	0	0	0	0	0	0	0	0	0		批量查询
玛卡有几个代理商	0	0	0	0	0	0	0	0	0	0	0	0	0	0	0		批量查询
玛卡代理商	0	0	0	0	0	0	0	0	0	0	0	0	0	0	0		批量查询
玛卡玛咖厂家直销	0	0	0	0	0	0	0	0	0	0	0	0	0	0	0		批量查询
如何代理玛卡	0	0	0	0	0	0	0	0	0	0	0	0	0	0	0		批量查询
云南玛卡代理	0	0	0	0	0	0	0	0	0	0	0	0	0	0	0		批量查询
玛卡怎么切片	0	0	0	0	0	0	0	0	0	0	0	0	0	0	0		批量查询
木氏玛卡精片	0	0	0	0	0	0	0	0	0	0	0	0	0	0	0		批量查询
云南木氏玛卡	0	0	0	0	0	0	0	0	0	0	0	0	0	0	0		批量查询
丽江木氏纯玛卡	0	0	0	0	0	0	0	0	0	0	0	0	0	0	0		批量查询
班寨玛卡精片	0	0	0	0	0	0	0	0	0	0	0	0	0	0	0		批量查询
什么牌子的玛卡最好	0	0	0	0	0	0	0	0	0	0	0	0	0	0	0		批量查询
哪个牌子的玛卡	0	0	0	0	0	0	0	0	0	0	0	0	0	0	0		批量查询
玛卡最好的牌子是什么	0	0	0	0	0	0	0	0	0	0	0	0	0	0	0		批量查询
帕米尔玛卡	0	0	0	0	0	0	0	0	0	0	0	0	0	0	0		批量查询
新疆帕米尔玛卡益康	0	0	0	0	0	0	0	0	0	0	0	0	0	0	0		批量查询
康美玛卡	0	0	0	0	0	0	0	0	0	0	0	0	0	0	0		批量查询
雪鼎玛卡x6	0	0	0	0	0	0	0	0	0	0	0	0	0	0	0		批量查询
雪鼎玛卡x8	0	0	0	0	0	0	0	0	0	0	0	0	0	0	0		批量查询
雪鼎玛卡精片	0	0	0	0	0	0	0	0	0	0	0	0	0	0	0		批量查询
天然玛卡黑色	0	0	0	0	0	0	0	0	0	0	0	0	0	0	0		批量查询
大海玛卡种子好吗	0	0	0	0	0	0	0	0	0	0	0	0	0	0	0		批量查询
玛卡种子那个好	0	0	0	0	0	0	0	0	0	0	0	0	0	0	0		批量查询
玛卡种子那里有售	0	0	0	0	0	0	0	0	0	0	0	0	0	0	0		批量查询
哪里有售玛卡种子	0	0	0	0	0	0	0	0	0	0	0	0	0	0	0		批量查询
活力达秘鲁进口玛卡怎么样	0	0	0	0	0	0	0	0	0	0	0	0	0	0	0		批量查询
玛卡oem代加工	0	0	0	0	0	0	0	0	0	0	0	0	0	0	0		批量查询
雪鼎玛卡干片	0	0	0	0	0	0	0	0	0	0	0	0	0	0	0		批量查询
玛卡秘鲁正品 雪鼎	0	0	0	0	0	0	0	0	0	0	0	0	0	0	0		批量查询
雪鼎 玛卡精片	0	0	0	0	0	0	0	0	0	0	0	0	0	0	0		批量查询
雪鼎玛咖玛卡	0	0	0	0	0	0	0	0	0	0	0	0	0	0	0		批量查询
玛卡苗	0	0	0	0	0	0	0	0	0	0	0	0	0	0	0		批量查询
育亨宾 玛卡	0	0	0	0	0	0	0	0	0	0	0	0	0	0	0		批量查询
gnc 秘鲁玛卡100粒	0	0	0	0	0	0	0	0	0	0	0	0	0	0	0		批量查询
gnc秘鲁玛卡maca	0	0	0	0	0	0	0	0	0	0	0	0	0	0	0		批量查询
gnc秘鲁玛卡	0	0	0	0	0	0	0	0	0	0	0	0	0	0	0		批量查询
gnc秘鲁玛卡 100	0	0	0	0	0	0	0	0	0	0	0	0	0	0	0		批量查询
gnc 玛卡 60粒	0	0	0	0	0	0	0	0	0	0	0	0	0	0	0		批量查询
gnc玛卡胶囊	0	0	0	0	0	0	0	0	0	0	0	0	0	0	0		批量查询
美国gnc玛卡	0	0	0	0	0	0	0	0	0	0	0	0	0	0	0		批量查询
gnc 淫羊藿 玛卡	0	0	0	0	0	0	0	0	0	0	0	0	0	0	0		批量查询
现货 gnc 玛卡	0	0	0	0	0	0	0	0	0	0	0	0	0	0	0		批量查询
明治玛卡精华	0	0	0	0	0	0	0	0	0	0	0	0	0	0	0		批量查询
明治 lola 玛卡	0	0	0	0	0	0	0	0	0	0	0	0	0	0	0		批量查询
日本明治玛卡	0	0	0	0	0	0	0	0	0	0	0	0	0	0	0		批量查询
香港买玛卡	0	0	0	0	0	0	0	0	0	0	0	0	0	0	0		批量查询
香港哪里 买玛卡	0	0	0	0	0	0	0	0	0	0	0	0	0	0	0		批量查询
玛卡与什么同吃好	0	0	0	0	0	0	0	0	0	0	0	0	0	0	0		批量查询
玛卡怎么吃好	0	0	0	0	0	0	0	0	0	0	0	0	0	0	0		批量查询
药店能买到玛卡吗	0	0	0	0	0	0	0	0	0	0	0	0	0	0	0		批量查询
勃咔玛咖玛卡补肾	0	0	0	0	0	0	0	0	0	0	0	0	0	0	0		批量查询
玛卡复合胶囊	0	0	0	0	0	0	0	0	0	0	0	0	0	0	0		批量查询
玛咖玛卡胶囊	0	0	0	0	0	0	0	0	0	0	0	0	0	0	0		批量查询
玛卡反应	0	0	0	0	0	0	0	0	0	0	0	0	0	0	0		批量查询
吃玛卡应该有何感觉	0	0	0	0	0	0	0	0	0	0	0	0	0	0	0		批量查询
玛卡饭前还是饭后吃呢	0	0	0	0	0	0	0	0	0	0	0	0	0	0	0		批量查询
玛卡饭前吃还是饭后吃	0	0	0	0	0	0	0	0	0	0	0	0	0	0	0		批量查询
手术后能吃玛卡吗	0	0	0	0	0	0	0	0	0	0	0	0	0	0	0		批量查询
玛卡饭前还是饭后吃	0	0	0	0	0	0	0	0	0	0	0	0	0	0	0		批量查询
玛卡吃了会上火吗	0	0	0	0	0	0	0	0	0	0	0	0	0	0	0		批量查询
玛卡吃了有什么作用	0	0	0	0	0	0	0	0	0	0	0	0	0	0	0		批量查询
玛卡吃了心跳会加快嘛	0	0	0	0	0	0	0	0	0	0	0	0	0	0	0		批量查询
吃了玛卡头疼问什么	0	0	0	0	0	0	0	0	0	0	0	0	0	0	0		批量查询
玛卡吃了没用	0	0	0	0	0	0	0	0	0	0	0	0	0	0	0		批量查询
吃了玛卡头疼	0	0	0	0	0	0	0	0	0	0	0	0	0	0	0		批量查询
2h2d玛卡片	0	0	0	0	0	0	0	0	0	0	0	0	0	0	0		批量查询
曰本2h2d黑玛卡	0	0	0	0	0	0	0	0	0	0	0	0	0	0	0		批量查询
玛卡黑玛卡区别	0	0	0	0	0	0	0	0	0	0	0	0	0	0	0		批量查询
黄玛卡	0	0	0	0	0	0	0	0	0	0	0	0	0	0	0		批量查询
黄玛卡粉	0	0	0	0	0	0	0	0	0	0	0	0	0	0	0		批量查询
那种玛卡是真的	0	0	0	0	0	0	0	0	0	0	0	0	0	0	0		批量查询
秘鲁玛卡求购信息	0	0	0	0	0	0	0	0	0	0	0	0	0	0	0		批量查询
昆明玛卡盛宴	0	0	0	0	0	0	0	0	0	0	0	0	0	0	0		批量查询
昆明玛卡酒	0	0	0	0	0	0	0	0	0	0	0	0	0	0	0		批量查询
玛卡成份	0	0	0	0	0	0	0	0	0	0	0	0	0	0	0		批量查询
新鲜玛卡可以泡水喝不	0	0	0	0	0	0	0	0	0	0	0	0	0	0	0		批量查询
玛卡能生吃不	0	0	0	0	0	0	0	0	0	0	0	0	0	0	0		批量查询
玛卡到底好使不	0	0	0	0	0	0	0	0	0	0	0	0	0	0	0		批量查询
玛卡可不可以泡开水喝	0	0	0	0	0	0	0	0	0	0	0	0	0	0	0		批量查询
怀孕可以不可以吃玛卡	0	0	0	0	0	0	0	0	0	0	0	0	0	0	0		批量查询
云南玛卡洒	0	0	0	0	0	0	0	0	0	0	0	0	0	0	0		批量查询
玛卡洒	0	0	0	0	0	0	0	0	0	0	0	0	0	0	0		批量查询
现代保健玛卡	0	0	0	0	0	0	0	0	0	0	0	0	0	0	0		批量查询
现代保健杂志玛卡	0	0	0	0	0	0	0	0	0	0	0	0	0	0	0		批量查询
玛卡 保健 日摄入量	0	0	0	0	0	0	0	0	0	0	0	0	0	0	0		批量查询
云南班寨秘鲁玛卡	0	0	0	0	0	0	0	0	0	0	0	0	0	0	0		批量查询
康比特 加 金装玛卡	0	0	0	0	0	0	0	0	0	0	0	0	0	0	0		批量查询
玛卡金片	0	0	0	0	0	0	0	0	0	0	0	0	0	0	0		批量查询
玛卡的作用有多大	0	0	0	0	0	0	0	0	0	0	0	0	0	0	0		批量查询
玛卡的作用是什么	0	0	0	0	0	0	0	0	0	0	0	0	0	0	0		批量查询
吃玛卡的作用	0	0	0	0	0	0	0	0	0	0	0	0	0	0	0		批量查询
云南玛卡合作社	0	0	0	0	0	0	0	0	0	0	0	0	0	0	0		批量查询
玛卡货到付款d	0	0	0	0	0	0	0	0	0	0	0	0	0	0	0		批量查询
女人吃玛卡有什么作用	0	0	0	0	0	0	0	0	0	0	0	0	0	0	0		批量查询
女人喝玛卡有什么作用	0	0	0	0	0	0	0	0	0	0	0	0	0	0	0		批量查询
玛卡西尼牛仔裤 男	0	0	0	0	0	0	0	0	0	0	0	0	0	0	0		批量查询
玛卡西尼夏季牛仔裤	0	0	0	0	0	0	0	0	0	0	0	0	0	0	0		批量查询
香港进出口玛卡公司	0	0	0	0	0	0	0	0	0	0	0	0	0	0	0		批量查询
香港关于玛卡	0	0	0	0	0	0	0	0	0	0	0	0	0	0	0		批量查询
香港玛卡	0	0	0	0	0	0	0	0	0	0	0	0	0	0	0		批量查询
玛卡保健茶	0	0	0	0	0	0	0	0	0	0	0	0	0	0	0		批量查询
玛卡袋泡茶	0	0	0	0	0	0	0	0	0	0	0	0	0	0	0		批量查询
秘鲁玛卡茶	0	0	0	0	0	0	0	0	0	0	0	0	0	0	0		批量查询
玛卡养生茶	0	0	0	0	0	0	0	0	0	0	0	0	0	0	0		批量查询
万松堂玛卡茶	0	0	0	0	0	0	0	0	0	0	0	0	0	0	0		批量查询
玛米玛卡官方旗舰店	0	0	0	0	0	0	0	0	0	0	0	0	0	0	0		批量查询
玛卡胶囊官方旗舰店	0	0	0	0	0	0	0	0	0	0	0	0	0	0	0		批量查询
玛卡官方旗舰店	0	0	0	0	0	0	0	0	0	0	0	0	0	0	0		批量查询
玛卡旗舰店	0	0	0	0	0	0	0	0	0	0	0	0	0	0	0		批量查询
now 玛卡	0	0	0	0	0	0	0	0	0	0	0	0	0	0	0		批量查询
now 玛卡副作用	0	0	0	0	0	0	0	0	0	0	0	0	0	0	0		批量查询
吃玛卡会导致尿频	0	0	0	0	0	0	0	0	0	0	0	0	0	0	0		批量查询
黄玛卡的功效	0	0	0	0	0	0	0	0	0	0	0	0	0	0	0		批量查询
有谁知道玛卡效果如何	0	0	0	0	0	0	0	0	0	0	0	0	0	0	0		批量查询
康恩贝 玛卡效果如何	0	0	0	0	0	0	0	0	0	0	0	0	0	0	0		批量查询
玛卡真实效果如何	0	0	0	0	0	0	0	0	0	0	0	0	0	0	0		批量查询
玛卡如何吃效果最好	0	0	0	0	0	0	0	0	0	0	0	0	0	0	0		批量查询
秘鲁玛卡入药产品	0	0	0	0	0	0	0	0	0	0	0	0	0	0	0		批量查询
哪个品牌的玛卡好	0	0	0	0	0	0	0	0	0	0	0	0	0	0	0		批量查询
云南玛卡公司有哪些	0	0	0	0	0	0	0	0	0	0	0	0	0	0	0		批量查询
哪种玛卡	0	0	0	0	0	0	0	0	0	0	0	0	0	0	0		批量查询
玛卡收购商	0	0	0	0	0	0	0	0	0	0	0	0	0	0	0		批量查询
丽江玛卡收购	0	0	0	0	0	0	0	0	0	0	0	0	0	0	0		批量查询
新鲜玛卡收购	0	0	0	0	0	0	0	0	0	0	0	0	0	0	0		批量查询
哪里的玛卡收购商	0	0	0	0	0	0	0	0	0	0	0	0	0	0	0		批量查询
大量收购玛卡	0	0	0	0	0	0	0	0	0	0	0	0	0	0	0		批量查询
玛卡泡水喝多久有效	0	0	0	0	0	0	0	0	0	0	0	0	0	0	0		批量查询
玛卡泡水上火吗	0	0	0	0	0	0	0	0	0	0	0	0	0	0	0		批量查询
康比特 玛卡	0	0	0	0	0	0	0	0	0	0	0	0	0	0	0		批量查询
玛卡益 康咀嚼	0	0	0	0	0	0	0	0	0	0	0	0	0	0	0		批量查询
康司坦丁 玛卡里奇	0	0	0	0	0	0	0	0	0	0	0	0	0	0	0		批量查询
康机玛卡	0	0	0	0	0	0	0	0	0	0	0	0	0	0	0		批量查询
三力康玛卡	0	0	0	0	0	0	0	0	0	0	0	0	0	0	0		批量查询
玛卡在哪里可以买到	0	0	0	0	0	0	0	0	0	0	0	0	0	0	0		批量查询
国外代购玛卡	0	0	0	0	0	0	0	0	0	0	0	0	0	0	0		批量查询
丽江极品黑玛卡干片	0	0	0	0	0	0	0	0	0	0	0	0	0	0	0		批量查询
玛卡健康视频下载	0	0	0	0	0	0	0	0	0	0	0	0	0	0	0		批量查询
云南香格里拉玛卡	0	0	0	0	0	0	0	0	0	0	0	0	0	0	0		批量查询
玛卡香格里拉 干果	0	0	0	0	0	0	0	0	0	0	0	0	0	0	0		批量查询
bakmk芭卡玛卡 男	0	0	0	0	0	0	0	0	0	0	0	0	0	0	0		批量查询
芭卡玛卡男包	0	0	0	0	0	0	0	0	0	0	0	0	0	0	0		批量查询
芭卡玛卡眼镜	0	0	0	0	0	0	0	0	0	0	0	0	0	0	0		批量查询
芭卡玛卡 双肩包	0	0	0	0	0	0	0	0	0	0	0	0	0	0	0		批量查询
芭卡玛卡摄像机	0	0	0	0	0	0	0	0	0	0	0	0	0	0	0		批量查询
芭卡玛卡单肩包	0	0	0	0	0	0	0	0	0	0	0	0	0	0	0		批量查询
芭卡玛卡伸缩狼牙棒	0	0	0	0	0	0	0	0	0	0	0	0	0	0	0		批量查询
芭卡玛卡多功能户外	0	0	0	0	0	0	0	0	0	0	0	0	0	0	0		批量查询
芭卡玛卡男包m9999	0	0	0	0	0	0	0	0	0	0	0	0	0	0	0		批量查询
玛卡业务员提成比例	0	0	0	0	0	0	0	0	0	0	0	0	0	0	0		批量查询
不同颜色玛卡的功效	0	0	0	0	0	0	0	0	0	0	0	0	0	0	0		批量查询
秘鲁玛卡可以出口吗	0	0	0	0	0	0	0	0	0	0	0	0	0	0	0		批量查询
bakmk芭卡玛卡 男女通用休闲腰包 韩版真皮胸包 男牛皮挎包户外腰包yb001 黑色	0	0	0	0	0	0	0	0	0	0	0	0	0	0	0		批量查询
bakmk芭卡玛卡 500倍变倍高清放大镜 数码显微镜	0	0	0	0	0	0	0	0	0	0	0	0	0	0	0		批量查询
bakmk芭卡玛卡 韩版帆布休闲包 男女单肩包 斜挎包 手提包975 卡其色	0	0	0	0	0	0	0	0	0	0	0	0	0	0	0		批量查询
芭卡玛卡移动电源	0	0	0	0	0	0	0	0	0	0	0	0	0	0	0		批量查询
玛卡虫草片	0	0	0	0	0	0	0	0	0	0	0	0	0	0	0		批量查询
北京玛卡文化传媒有限责任公司	0	0	0	0	0	0	0	0	0	0	0	0	0	0	0		批量查询
lvci玛卡虫草玛咖	0	0	0	0	0	0	0	0	0	0	0	0	0	0	0		批量查询
虫草玛卡王	0	0	0	0	0	0	0	0	0	0	0	0	0	0	0		批量查询
玛卡能和黑松露泡酒吗	0	0	0	0	0	0	0	0	0	0	0	0	0	0	0		批量查询
玛卡虫草王可以乱吃吗	0	0	0	0	0	0	0	0	0	0	0	0	0	0	0		批量查询
bakmk芭卡玛卡腰包	0	0	0	0	0	0	0	0	0	0	0	0	0	0	0		批量查询
bakmk 芭卡玛卡 双肩包	0	0	0	0	0	0	0	0	0	0	0	0	0	0	0		批量查询
芭卡玛卡帆布包	0	0	0	0	0	0	0	0	0	0	0	0	0	0	0		批量查询
芭卡玛卡斜跨包	0	0	0	0	0	0	0	0	0	0	0	0	0	0	0		批量查询
芭卡玛卡 帆布 腰包	0	0	0	0	0	0	0	0	0	0	0	0	0	0	0		批量查询
玛卡糖女人能吃吗	0	0	0	0	0	0	0	0	0	0	0	0	0	0	0		批量查询
玛卡糖	0	0	0	0	0	0	0	0	0	0	0	0	0	0	0		批量查询
lamolina拉摩力拉玛卡	0	0	0	0	0	0	0	0	0	0	0	0	0	0	0		批量查询
美国izuo勃咔玛咖玛卡	0	0	0	0	0	0	0	0	0	0	0	0	0	0	0		批量查询
自然之宝玛卡	0	0	0	0	0	0	0	0	0	0	0	0	0	0	0		批量查询
宝天健玛卡益康咀嚼片	0	0	0	0	0	0	0	0	0	0	0	0	0	0	0		批量查询
宝天健玛卡酒	0	0	0	0	0	0	0	0	0	0	0	0	0	0	0		批量查询
自然之宝玛卡套装	0	0	0	0	0	0	0	0	0	0	0	0	0	0	0		批量查询
玛卡易身片	0	0	0	0	0	0	0	0	0	0	0	0	0	0	0		批量查询
中药玛卡用法	0	0	0	0	0	0	0	0	0	0	0	0	0	0	0		批量查询
云南玛卡用法	0	0	0	0	0	0	0	0	0	0	0	0	0	0	0		批量查询
黄金玛卡用法	0	0	0	0	0	0	0	0	0	0	0	0	0	0	0		批量查询
云南生玛卡用法	0	0	0	0	0	0	0	0	0	0	0	0	0	0	0		批量查询
玛卡凝露怎么用法	0	0	0	0	0	0	0	0	0	0	0	0	0	0	0		批量查询
云南曲靖玛卡种植园	0	0	0	0	0	0	0	0	0	0	0	0	0	0	0		批量查询
曲靖玛卡	0	0	0	0	0	0	0	0	0	0	0	0	0	0	0		批量查询
玛咖玛卡 秘鲁国宝	0	0	0	0	0	0	0	0	0	0	0	0	0	0	0		批量查询
玛卡北京	0	0	0	0	0	0	0	0	0	0	0	0	0	0	0		批量查询
玛卡虫草复合片	0	0	0	0	0	0	0	0	0	0	0	0	0	0	0		批量查询
lvci玛卡虫草复合片	0	0	0	0	0	0	0	0	0	0	0	0	0	0	0		批量查询
lvci玛卡虫草片	0	0	0	0	0	0	0	0	0	0	0	0	0	0	0		批量查询
虫草玛卡精片	0	0	0	0	0	0	0	0	0	0	0	0	0	0	0		批量查询
玛卡蛹虫草精片	0	0	0	0	0	0	0	0	0	0	0	0	0	0	0		批量查询
蛹虫草玛卡	0	0	0	0	0	0	0	0	0	0	0	0	0	0	0		批量查询
云南玛卡有效果吗	0	0	0	0	0	0	0	0	0	0	0	0	0	0	0		批量查询
女性服用玛卡的功效	0	0	0	0	0	0	0	0	0	0	0	0	0	0	0		批量查询
女性能否服用玛卡	0	0	0	0	0	0	0	0	0	0	0	0	0	0	0		批量查询
玛卡女性怎样服用	0	0	0	0	0	0	0	0	0	0	0	0	0	0	0		批量查询
老年人 玛卡	0	0	0	0	0	0	0	0	0	0	0	0	0	0	0		批量查询
老年人能吃玛卡吗	0	0	0	0	0	0	0	0	0	0	0	0	0	0	0		批量查询
服用玛卡7天了没效果	0	0	0	0	0	0	0	0	0	0	0	0	0	0	0		批量查询
怎样服用玛卡效果最好	0	0	0	0	0	0	0	0	0	0	0	0	0	0	0		批量查询
玛卡的日用量	0	0	0	0	0	0	0	0	0	0	0	0	0	0	0		批量查询
丽江百岁坊玛卡	0	0	0	0	0	0	0	0	0	0	0	0	0	0	0		批量查询
玛卡百岁坊	0	0	0	0	0	0	0	0	0	0	0	0	0	0	0		批量查询
2h2d 精之自信黑玛卡	0	0	0	0	0	0	0	0	0	0	0	0	0	0	0		批量查询
丸荣2h2d黑玛卡	0	0	0	0	0	0	0	0	0	0	0	0	0	0	0		批量查询
秘鲁玛卡 增大增粗	0	0	0	0	0	0	0	0	0	0	0	0	0	0	0		批量查询
玛卡 延时增大增粗	0	0	0	0	0	0	0	0	0	0	0	0	0	0	0		批量查询
玛卡 男用延时增大	0	0	0	0	0	0	0	0	0	0	0	0	0	0	0		批量查询
糖尿病患者能吃玛卡吗	0	0	0	0	0	0	0	0	0	0	0	0	0	0	0		批量查询
玛卡糖尿病能吃吗	0	0	0	0	0	0	0	0	0	0	0	0	0	0	0		批量查询
控制糖尿病能吃玛卡吗	0	0	0	0	0	0	0	0	0	0	0	0	0	0	0		批量查询
糖尿病人能吃玛卡	0	0	0	0	0	0	0	0	0	0	0	0	0	0	0		批量查询
玛卡与糖尿病	0	0	0	0	0	0	0	0	0	0	0	0	0	0	0		批量查询
吃玛卡能喝茶吗	0	0	0	0	0	0	0	0	0	0	0	0	0	0	0		批量查询
吃玛卡可以喝茶吗	0	0	0	0	0	0	0	0	0	0	0	0	0	0	0		批量查询
玛卡泡多久才可以喝	0	0	0	0	0	0	0	0	0	0	0	0	0	0	0		批量查询
吃玛卡酒血糖会高吗	0	0	0	0	0	0	0	0	0	0	0	0	0	0	0		批量查询
玛卡切片机	0	0	0	0	0	0	0	0	0	0	0	0	0	0	0		批量查询
玛卡哪些牌子好	0	0	0	0	0	0	0	0	0	0	0	0	0	0	0		批量查询
玛卡干片好还是药片好	0	0	0	0	0	0	0	0	0	0	0	0	0	0	0		批量查询
玛卡 国内药店有卖吗	0	0	0	0	0	0	0	0	0	0	0	0	0	0	0		批量查询
国内有没有玛卡种植	0	0	0	0	0	0	0	0	0	0	0	0	0	0	0		批量查询
国内品牌玛卡	0	0	0	0	0	0	0	0	0	0	0	0	0	0	0		批量查询
国外玛卡价格	0	0	0	0	0	0	0	0	0	0	0	0	0	0	0		批量查询
国外对玛卡的评价	0	0	0	0	0	0	0	0	0	0	0	0	0	0	0		批量查询
国内玛卡哪家生产的好	0	0	0	0	0	0	0	0	0	0	0	0	0	0	0		批量查询
云南黑玛咖秘鲁玛卡正品	0	0	0	0	0	0	0	0	0	0	0	0	0	0	0		批量查询
2h2d玛卡maca	0	0	0	0	0	0	0	0	0	0	0	0	0	0	0		批量查询
丸荣2h2d玛卡	0	0	0	0	0	0	0	0	0	0	0	0	0	0	0		批量查询
2h 2d 黑钻 玛卡	0	0	0	0	0	0	0	0	0	0	0	0	0	0	0		批量查询
日本2h2d黑钻玛卡	0	0	0	0	0	0	0	0	0	0	0	0	0	0	0		批量查询
2h2d秘鲁黑钻玛卡	0	0	0	0	0	0	0	0	0	0	0	0	0	0	0		批量查询
2h&2d玛卡	0	0	0	0	0	0	0	0	0	0	0	0	0	0	0		批量查询
日本丸荣2h2d黑玛卡	0	0	0	0	0	0	0	0	0	0	0	0	0	0	0		批量查询
2h2d延时喷剂黑玛卡	0	0	0	0	0	0	0	0	0	0	0	0	0	0	0		批量查询
2h2d秘鲁黑玛卡	0	0	0	0	0	0	0	0	0	0	0	0	0	0	0		批量查询
日本2h2d黑玛卡	0	0	0	0	0	0	0	0	0	0	0	0	0	0	0		批量查询
2h&2d黑玛卡	0	0	0	0	0	0	0	0	0	0	0	0	0	0	0		批量查询
玛卡男士精油	0	0	0	0	0	0	0	0	0	0	0	0	0	0	0		批量查询
玛卡男士精华素	0	0	0	0	0	0	0	0	0	0	0	0	0	0	0		批量查询
男士专用玛卡	0	0	0	0	0	0	0	0	0	0	0	0	0	0	0		批量查询
玛卡男士保健	0	0	0	0	0	0	0	0	0	0	0	0	0	0	0		批量查询
玛卡男士保健用品	0	0	0	0	0	0	0	0	0	0	0	0	0	0	0		批量查询
男士补肾玛卡	0	0	0	0	0	0	0	0	0	0	0	0	0	0	0		批量查询
康比特 玛卡精华片	0	0	0	0	0	0	0	0	0	0	0	0	0	0	0		批量查询
玛卡秘鲁精华片	0	0	0	0	0	0	0	0	0	0	0	0	0	0	0		批量查询
金装玛卡精华片	0	0	0	0	0	0	0	0	0	0	0	0	0	0	0		批量查询
云南玛卡切片	0	0	0	0	0	0	0	0	0	0	0	0	0	0	0		批量查询
秘鲁玛卡切片	0	0	0	0	0	0	0	0	0	0	0	0	0	0	0		批量查询
正品 玛卡 干果切片	0	0	0	0	0	0	0	0	0	0	0	0	0	0	0		批量查询
玛卡干切片	0	0	0	0	0	0	0	0	0	0	0	0	0	0	0		批量查询
黄玛卡切片	0	0	0	0	0	0	0	0	0	0	0	0	0	0	0		批量查询
黑玛卡切片	0	0	0	0	0	0	0	0	0	0	0	0	0	0	0		批量查询
玛卡干果切片	0	0	0	0	0	0	0	0	0	0	0	0	0	0	0		批量查询
金装玛卡	0	0	0	0	0	0	0	0	0	0	0	0	0	0	0		批量查询
玛咖是不是玛卡	0	0	0	0	0	0	0	0	0	0	0	0	0	0	0		批量查询
玛卡 天猫	0	0	0	0	0	0	0	0	0	0	0	0	0	0	0		批量查询
玛卡一天煮多少量	0	0	0	0	0	0	0	0	0	0	0	0	0	0	0		批量查询
玛卡根粉	0	0	0	0	0	0	0	0	0	0	0	0	0	0	0		批量查询
新疆有玛卡中药材吗	0	0	0	0	0	0	0	0	0	0	0	0	0	0	0		批量查询
活力达秘鲁进口玛卡精片90片\\\\\\\/瓶	0	0	0	0	0	0	0	0	0	0	0	0	0	0	0		批量查询
决战奥格瑞玛卡bug	0	0	0	0	0	0	0	0	0	0	0	0	0	0	0		批量查询
爱司盟玛卡胶囊	0	0	0	0	0	0	0	0	0	0	0	0	0	0	0		批量查询
25人奥格瑞玛卡bug	0	0	0	0	0	0	0	0	0	0	0	0	0	0	0		批量查询
女性玛卡怎么吃	0	0	0	0	0	0	0	0	0	0	0	0	0	0	0		批量查询
玛卡益康片女性可服吗	0	0	0	0	0	0	0	0	0	0	0	0	0	0	0		批量查询
玛卡图鞋	0	0	0	0	0	0	0	0	0	0	0	0	0	0	0		批量查询
玛卡功效图	0	0	0	0	0	0	0	0	0	0	0	0	0	0	0		批量查询
玛卡块根图	0	0	0	0	0	0	0	0	0	0	0	0	0	0	0		批量查询
玛卡外用	0	0	0	0	0	0	0	0	0	0	0	0	0	0	0		批量查询
秘鲁国玛卡哪里买到	0	0	0	0	0	0	0	0	0	0	0	0	0	0	0		批量查询
秘鲁玛卡产量	0	0	0	0	0	0	0	0	0	0	0	0	0	0	0		批量查询
玛卡原植物怎么用	0	0	0	0	0	0	0	0	0	0	0	0	0	0	0		批量查询
怎样用玛卡泡酒	0	0	0	0	0	0	0	0	0	0	0	0	0	0	0		批量查询
肾虚 玛卡	0	0	0	0	0	0	0	0	0	0	0	0	0	0	0		批量查询
秘鲁 玛卡干片 肾虚	0	0	0	0	0	0	0	0	0	0	0	0	0	0	0		批量查询
50岁男适合吃玛卡吗	0	0	0	0	0	0	0	0	0	0	0	0	0	0	0		批量查询
玛卡干果 礼盒装	0	0	0	0	0	0	0	0	0	0	0	0	0	0	0		批量查询
玛卡益康咀嚼片旗舰店	0	0	0	0	0	0	0	0	0	0	0	0	0	0	0		批量查询
秘鲁原装拉摩力拉牌玛卡片	0	0	0	0	0	0	0	0	0	0	0	0	0	0	0		批量查询
秘鲁原装进口玛卡	0	0	0	0	0	0	0	0	0	0	0	0	0	0	0		批量查询
原装秘鲁配方 玛卡片玛咖	0	0	0	0	0	0	0	0	0	0	0	0	0	0	0		批量查询
玛卡干片价格	0	0	0	0	0	0	0	0	0	0	0	0	0	0	0		批量查询
玛卡粉一天吃多少	0	0	0	0	0	0	0	0	0	0	0	0	0	0	0		批量查询
玛卡粉最佳服用方法	0	0	0	0	0	0	0	0	0	0	0	0	0	0	0		批量查询
玛卡粉女人吃效果好吗	0	0	0	0	0	0	0	0	0	0	0	0	0	0	0		批量查询
玛卡粉一次服用多少	0	0	0	0	0	0	0	0	0	0	0	0	0	0	0		批量查询
玛卡粉的食用方法	0	0	0	0	0	0	0	0	0	0	0	0	0	0	0		批量查询
云南玛卡粉怎么吃	0	0	0	0	0	0	0	0	0	0	0	0	0	0	0		批量查询
玛卡粉怎么服用	0	0	0	0	0	0	0	0	0	0	0	0	0	0	0		批量查询
玛卡粉的吃法	0	0	0	0	0	0	0	0	0	0	0	0	0	0	0		批量查询
玛卡粉服用方法	0	0	0	0	0	0	0	0	0	0	0	0	0	0	0		批量查询
玛卡干片500克	0	0	0	0	0	0	0	0	0	0	0	0	0	0	0		批量查询
玛卡干片500	0	0	0	0	0	0	0	0	0	0	0	0	0	0	0		批量查询
玛卡干片干果	0	0	0	0	0	0	0	0	0	0	0	0	0	0	0		批量查询
玛卡干片补肾	0	0	0	0	0	0	0	0	0	0	0	0	0	0	0		批量查询
玛卡干片 秘鲁	0	0	0	0	0	0	0	0	0	0	0	0	0	0	0		批量查询
玛卡干片50克	0	0	0	0	0	0	0	0	0	0	0	0	0	0	0		批量查询
玛卡干片丽人装	0	0	0	0	0	0	0	0	0	0	0	0	0	0	0		批量查询
玛卡干片包邮	0	0	0	0	0	0	0	0	0	0	0	0	0	0	0		批量查询
玛卡干片500g	0	0	0	0	0	0	0	0	0	0	0	0	0	0	0		批量查询
玛卡干片 保健品	0	0	0	0	0	0	0	0	0	0	0	0	0	0	0		批量查询
丽江玛卡干果	0	0	0	0	0	0	0	0	0	0	0	0	0	0	0		批量查询
紫玛卡干果	0	0	0	0	0	0	0	0	0	0	0	0	0	0	0		批量查询
秘鲁进口玛卡干果	0	0	0	0	0	0	0	0	0	0	0	0	0	0	0		批量查询
玛卡秘鲁正品 干果	0	0	0	0	0	0	0	0	0	0	0	0	0	0	0		批量查询
黄玛卡干果	0	0	0	0	0	0	0	0	0	0	0	0	0	0	0		批量查询
云南玛卡干果	0	0	0	0	0	0	0	0	0	0	0	0	0	0	0		批量查询
玛卡干果 干片	0	0	0	0	0	0	0	0	0	0	0	0	0	0	0		批量查询
玛卡秘鲁正品精片	0	0	0	0	0	0	0	0	0	0	0	0	0	0	0		批量查询
玛卡秘鲁正品牌	0	0	0	0	0	0	0	0	0	0	0	0	0	0	0		批量查询
玛卡秘鲁正品 进口	0	0	0	0	0	0	0	0	0	0	0	0	0	0	0		批量查询
玛卡秘鲁正品 拉牌	0	0	0	0	0	0	0	0	0	0	0	0	0	0	0		批量查询
玛卡秘鲁正品 延时	0	0	0	0	0	0	0	0	0	0	0	0	0	0	0		批量查询
玛卡秘鲁正品 云南	0	0	0	0	0	0	0	0	0	0	0	0	0	0	0		批量查询
玛卡秘鲁正品 益康	0	0	0	0	0	0	0	0	0	0	0	0	0	0	0		批量查询
玛卡秘鲁正品 增大	0	0	0	0	0	0	0	0	0	0	0	0	0	0	0		批量查询
玛卡秘鲁正品 摩力	0	0	0	0	0	0	0	0	0	0	0	0	0	0	0		批量查询
原装秘鲁玛卡	0	0	0	0	0	0	0	0	0	0	0	0	0	0	0		批量查询
原装进口秘鲁玛卡官网	0	0	0	0	0	0	0	0	0	0	0	0	0	0	0		批量查询
玛卡干片 散装	0	0	0	0	0	0	0	0	0	0	0	0	0	0	0		批量查询
丽江玛卡干片	0	0	0	0	0	0	0	0	0	0	0	0	0	0	0		批量查询
紫玛卡干片	0	0	0	0	0	0	0	0	0	0	0	0	0	0	0		批量查询
秘鲁玛卡干片	0	0	0	0	0	0	0	0	0	0	0	0	0	0	0		批量查询
黄玛卡干片	0	0	0	0	0	0	0	0	0	0	0	0	0	0	0		批量查询
云南玛卡干片	0	0	0	0	0	0	0	0	0	0	0	0	0	0	0		批量查询
玛卡 玛咖 干片 干果	0	0	0	0	0	0	0	0	0	0	0	0	0	0	0		批量查询
中药 玛卡干果干片	0	0	0	0	0	0	0	0	0	0	0	0	0	0	0		批量查询
会泽玛卡干片	0	0	0	0	0	0	0	0	0	0	0	0	0	0	0		批量查询
玛卡男人吃了的功效	0	0	0	0	0	0	0	0	0	0	0	0	0	0	0		批量查询
玛卡干果怎样吃效果好	0	0	0	0	0	0	0	0	0	0	0	0	0	0	0		批量查询
丽江玛卡干果怎么泡酒	0	0	0	0	0	0	0	0	0	0	0	0	0	0	0		批量查询
玛卡干果怎么吃	0	0	0	0	0	0	0	0	0	0	0	0	0	0	0		批量查询
云南玛卡干果价格	0	0	0	0	0	0	0	0	0	0	0	0	0	0	0		批量查询
现在丽江玛卡干果价格	0	0	0	0	0	0	0	0	0	0	0	0	0	0	0		批量查询
玛卡干果的食用方法	0	0	0	0	0	0	0	0	0	0	0	0	0	0	0		批量查询
玛卡干果多少一斤	0	0	0	0	0	0	0	0	0	0	0	0	0	0	0		批量查询
丽江玛卡干果价格	0	0	0	0	0	0	0	0	0	0	0	0	0	0	0		批量查询
云南玛卡干果怎么吃	0	0	0	0	0	0	0	0	0	0	0	0	0	0	0		批量查询
玛卡秘鲁正品补肾超2h2d玛咖	0	0	0	0	0	0	0	0	0	0	0	0	0	0	0		批量查询
秘鲁拉摩力拉牌玛卡正品玛咖	0	0	0	0	0	0	0	0	0	0	0	0	0	0	0		批量查询
玛卡秘鲁正品 原装进口	0	0	0	0	0	0	0	0	0	0	0	0	0	0	0		批量查询
玛卡秘鲁正品60片	0	0	0	0	0	0	0	0	0	0	0	0	0	0	0		批量查询
秘鲁玛卡片女人能吃吗	0	0	0	0	0	0	0	0	0	0	0	0	0	0	0		批量查询
玛卡的市场价	0	0	0	0	0	0	0	0	0	0	0	0	0	0	0		批量查询
摩力拉牌玛卡片 骗局	0	0	0	0	0	0	0	0	0	0	0	0	0	0	0		批量查询
云南玛卡图片	0	0	0	0	0	0	0	0	0	0	0	0	0	0	0		批量查询
云南野生玛卡图片	0	0	0	0	0	0	0	0	0	0	0	0	0	0	0		批量查询
玛卡益康片多久见效	0	0	0	0	0	0	0	0	0	0	0	0	0	0	0		批量查询
玛卡干片怎么吃	0	0	0	0	0	0	0	0	0	0	0	0	0	0	0		批量查询
玛卡干片 食用方法	0	0	0	0	0	0	0	0	0	0	0	0	0	0	0		批量查询
玛卡干片怎么吃效果好	0	0	0	0	0	0	0	0	0	0	0	0	0	0	0		批量查询
玛卡干片干果的吃法	0	0	0	0	0	0	0	0	0	0	0	0	0	0	0		批量查询
玛卡干片味道很辣	0	0	0	0	0	0	0	0	0	0	0	0	0	0	0		批量查询
玛卡干片泡茶效果怎样	0	0	0	0	0	0	0	0	0	0	0	0	0	0	0		批量查询
黑玛卡干片批发	0	0	0	0	0	0	0	0	0	0	0	0	0	0	0		批量查询
玛卡干片干果如何吃好	0	0	0	0	0	0	0	0	0	0	0	0	0	0	0		批量查询
玛卡云南元素 干果	0	0	0	0	0	0	0	0	0	0	0	0	0	0	0		批量查询
玛卡云南元素 男人	0	0	0	0	0	0	0	0	0	0	0	0	0	0	0		批量查询
玛卡云南元素 延时	0	0	0	0	0	0	0	0	0	0	0	0	0	0	0		批量查询
玛卡云南元素 补肾	0	0	0	0	0	0	0	0	0	0	0	0	0	0	0		批量查询
玛卡云南元素 秘鲁	0	0	0	0	0	0	0	0	0	0	0	0	0	0	0		批量查询
玛卡云南元素 干果.	0	0	0	0	0	0	0	0	0	0	0	0	0	0	0		批量查询
玛卡云南元素 保健品	0	0	0	0	0	0	0	0	0	0	0	0	0	0	0		批量查询
玛卡云南元素 泡酒	0	0	0	0	0	0	0	0	0	0	0	0	0	0	0		批量查询
云南元素玛卡精片	0	0	0	0	0	0	0	0	0	0	0	0	0	0	0		批量查询
云南元素丽江玛卡	0	0	0	0	0	0	0	0	0	0	0	0	0	0	0		批量查询
伽玛卡兹	0	0	0	0	0	0	0	0	0	0	0	0	0	0	0		批量查询
玛卡的功效与吃法	0	0	0	0	0	0	0	0	0	0	0	0	0	0	0		批量查询
玛卡秘鲁干果	0	0	0	0	0	0	0	0	0	0	0	0	0	0	0		批量查询
玛卡片的功效	0	0	0	0	0	0	0	0	0	0	0	0	0	0	0		批量查询
秘鲁野生玛卡	0	0	0	0	0	0	0	0	0	0	0	0	0	0	0		批量查询
玛卡片怎样吃效果最好	0	0	0	0	0	0	0	0	0	0	0	0	0	0	0		批量查询
玛卡巴卡毛绒玩具	0	0	0	0	0	0	0	0	0	0	0	0	0	0	0		批量查询
玛卡巴卡小推车	0	0	0	0	0	0	0	0	0	0	0	0	0	0	0		批量查询
玛卡巴卡 推推车	0	0	0	0	0	0	0	0	0	0	0	0	0	0	0		批量查询
玛卡巴卡玩具	0	0	0	0	0	0	0	0	0	0	0	0	0	0	0		批量查询
玛卡巴卡的小推推车	0	0	0	0	0	0	0	0	0	0	0	0	0	0	0		批量查询
玛卡巴卡洗澡玩具	0	0	0	0	0	0	0	0	0	0	0	0	0	0	0		批量查询
玛卡巴卡 洗澡	0	0	0	0	0	0	0	0	0	0	0	0	0	0	0		批量查询
花园宝宝 玛卡巴卡	0	0	0	0	0	0	0	0	0	0	0	0	0	0	0		批量查询
玛卡益康咀嚼片官网	0	0	0	0	0	0	0	0	0	0	0	0	0	0	0		批量查询
海龟先生 玛卡瑞纳	0	0	0	0	0	0	0	0	0	0	0	0	0	0	0		批量查询
秘鲁玛卡正品哪里买	0	0	0	0	0	0	0	0	0	0	0	0	0	0	0		批量查询
玛卡 秘鲁 正品 增大	0	0	0	0	0	0	0	0	0	0	0	0	0	0	0		批量查询
黑玛咖秘鲁玛卡正品	0	0	0	0	0	0	0	0	0	0	0	0	0	0	0		批量查询
正品的秘鲁玛卡咀嚼片	0	0	0	0	0	0	0	0	0	0	0	0	0	0	0		批量查询
秘鲁进口正品玛卡	0	0	0	0	0	0	0	0	0	0	0	0	0	0	0		批量查询
玛卡益康咀嚼片 进口	0	0	0	0	0	0	0	0	0	0	0	0	0	0	0		批量查询
玛卡巴卡 玩具	0	0	0	0	0	0	0	0	0	0	0	0	0	0	0		批量查询
玛卡巴卡童装店	0	0	0	0	0	0	0	0	0	0	0	0	0	0	0		批量查询
maca 玛卡提取物	0	0	0	0	0	0	0	0	0	0	0	0	0	0	0		批量查询
云南元素玛卡	0	0	0	0	0	0	0	0	0	0	0	0	0	0	0		批量查询
云南的玛卡多少钱一斤	0	0	0	0	0	0	0	0	0	0	0	0	0	0	0		批量查询
玛卡云南买多少钱一克	0	0	0	0	0	0	0	0	0	0	0	0	0	0	0		批量查询
云南玛卡怎么吃	0	0	0	0	0	0	0	0	0	0	0	0	0	0	0		批量查询
云南玛卡怎么吃最好	0	0	0	0	0	0	0	0	0	0	0	0	0	0	0		批量查询
云南玛卡的功效与作用	0	0	0	0	0	0	0	0	0	0	0	0	0	0	0		批量查询
云南新鲜玛卡怎么吃	0	0	0	0	0	0	0	0	0	0	0	0	0	0	0		批量查询
玛卡保健品日本	0	0	0	0	0	0	0	0	0	0	0	0	0	0	0		批量查询
玛卡保健品 补肾	0	0	0	0	0	0	0	0	0	0	0	0	0	0	0		批量查询
玛卡男性保健品	0	0	0	0	0	0	0	0	0	0	0	0	0	0	0		批量查询
男人保健品玛卡	0	0	0	0	0	0	0	0	0	0	0	0	0	0	0		批量查询
女人用保健品玛卡	0	0	0	0	0	0	0	0	0	0	0	0	0	0	0		批量查询
保健品男用 玛卡	0	0	0	0	0	0	0	0	0	0	0	0	0	0	0		批量查询
男士保健品 玛卡	0	0	0	0	0	0	0	0	0	0	0	0	0	0	0		批量查询
男保健品 玛卡	0	0	0	0	0	0	0	0	0	0	0	0	0	0	0		批量查询
进口玛卡保健品	0	0	0	0	0	0	0	0	0	0	0	0	0	0	0		批量查询
玛卡提取物片	0	0	0	0	0	0	0	0	0	0	0	0	0	0	0		批量查询
玛卡提取物100克	0	0	0	0	0	0	0	0	0	0	0	0	0	0	0		批量查询
玛卡酰胺提取物厂家	0	0	0	0	0	0	0	0	0	0	0	0	0	0	0		批量查询
植物提取物玛卡	0	0	0	0	0	0	0	0	0	0	0	0	0	0	0		批量查询
玛卡提取物20 1	0	0	0	0	0	0	0	0	0	0	0	0	0	0	0		批量查询
云南玛卡提取物	0	0	0	0	0	0	0	0	0	0	0	0	0	0	0		批量查询
纯天然补肾壮阳原料药 玛卡提取物	0	0	0	0	0	0	0	0	0	0	0	0	0	0	0		批量查询
玛卡益康咀嚼片 补肾	0	0	0	0	0	0	0	0	0	0	0	0	0	0	0		批量查询
玛卡益康咀嚼片正品	0	0	0	0	0	0	0	0	0	0	0	0	0	0	0		批量查询
玛卡益康咀嚼片12粒	0	0	0	0	0	0	0	0	0	0	0	0	0	0	0		批量查询
玛卡是什?价格	0	0	0	0	0	0	0	0	0	0	0	0	0	0	0		批量查询
玛卡玛咖	0	0	0	0	0	0	0	0	0	0	0	0	0	0	0		批量查询
玛卡益康咀嚼片批发	0	0	0	0	0	0	0	0	0	0	0	0	0	0	0		批量查询
花园宝宝玛卡巴卡原图	0	0	0	0	0	0	0	0	0	0	0	0	0	0	0		批量查询
玛卡巴卡的小车	0	0	0	0	0	0	0	0	0	0	0	0	0	0	0		批量查询
玛卡巴卡童装	0	0	0	0	0	0	0	0	0	0	0	0	0	0	0		批量查询
玩具玛卡巴卡	0	0	0	0	0	0	0	0	0	0	0	0	0	0	0		批量查询
玛卡益康咀嚼片男用	0	0	0	0	0	0	0	0	0	0	0	0	0	0	0		批量查询
玛卡男人保健品	0	0	0	0	0	0	0	0	0	0	0	0	0	0	0		批量查询
进口秘鲁玛卡胶保健品	0	0	0	0	0	0	0	0	0	0	0	0	0	0	0		批量查询
玛卡壮阳保健品	0	0	0	0	0	0	0	0	0	0	0	0	0	0	0		批量查询
性保健品玛卡	0	0	0	0	0	0	0	0	0	0	0	0	0	0	0		批量查询
黄金玛卡保健品	0	0	0	0	0	0	0	0	0	0	0	0	0	0	0		批量查询
男性延时保健品 鲁玛卡	0	0	0	0	0	0	0	0	0	0	0	0	0	0	0		批量查询
玛卡瑞纳是什么意思	0	0	0	0	0	0	0	0	0	0	0	0	0	0	0		批量查询
玛卡瑞纳吉他谱	0	0	0	0	0	0	0	0	0	0	0	0	0	0	0		批量查询
玛卡瑞纳空间链接	0	0	0	0	0	0	0	0	0	0	0	0	0	0	0		批量查询
玛卡瑞纳歌词	0	0	0	0	0	0	0	0	0	0	0	0	0	0	0		批量查询
福清玛卡瑞纳	0	0	0	0	0	0	0	0	0	0	0	0	0	0	0		批量查询
玛卡瑞纳 伴奏	0	0	0	0	0	0	0	0	0	0	0	0	0	0	0		批量查询
玛卡瑞纳 乐队谱子	0	0	0	0	0	0	0	0	0	0	0	0	0	0	0		批量查询
玛卡瑞纳 gtp	0	0	0	0	0	0	0	0	0	0	0	0	0	0	0		批量查询
玛卡包装盒	0	0	0	0	0	0	0	0	0	0	0	0	0	0	0		批量查询
玛卡包装盒礼盒	0	0	0	0	0	0	0	0	0	0	0	0	0	0	0		批量查询
玛卡包装袋	0	0	0	0	0	0	0	0	0	0	0	0	0	0	0		批量查询
玛卡包装盒 空盒子	0	0	0	0	0	0	0	0	0	0	0	0	0	0	0		批量查询
玛卡包装瓶	0	0	0	0	0	0	0	0	0	0	0	0	0	0	0		批量查询
玛卡包装盒批发	0	0	0	0	0	0	0	0	0	0	0	0	0	0	0		批量查询
玛卡包装袋子	0	0	0	0	0	0	0	0	0	0	0	0	0	0	0		批量查询
玛卡包装空盒	0	0	0	0	0	0	0	0	0	0	0	0	0	0	0		批量查询
玛卡包装盒子	0	0	0	0	0	0	0	0	0	0	0	0	0	0	0		批量查询
玛卡包装礼盒	0	0	0	0	0	0	0	0	0	0	0	0	0	0	0		批量查询
玛卡玛莎连衣裙短裙	0	0	0	0	0	0	0	0	0	0	0	0	0	0	0		批量查询
水溶性玛卡提取物	0	0	0	0	0	0	0	0	0	0	0	0	0	0	0		批量查询
玛卡提取物 hs号	0	0	0	0	0	0	0	0	0	0	0	0	0	0	0		批量查询
供应玛卡提取物	0	0	0	0	0	0	0	0	0	0	0	0	0	0	0		批量查询
玛卡提取物的用量	0	0	0	0	0	0	0	0	0	0	0	0	0	0	0		批量查询
西安玛卡提取物	0	0	0	0	0	0	0	0	0	0	0	0	0	0	0		批量查询
玛卡提取物怎么使用	0	0	0	0	0	0	0	0	0	0	0	0	0	0	0		批量查询
供应玛卡提取物价格	0	0	0	0	0	0	0	0	0	0	0	0	0	0	0		批量查询
玛卡提取物价格	0	0	0	0	0	0	0	0	0	0	0	0	0	0	0		批量查询
玛卡礼盒包装	0	0	0	0	0	0	0	0	0	0	0	0	0	0	0		批量查询
秘鲁玛卡包装	0	0	0	0	0	0	0	0	0	0	0	0	0	0	0		批量查询
玛卡干果包装瓶子	0	0	0	0	0	0	0	0	0	0	0	0	0	0	0		批量查询
玛卡片包装	0	0	0	0	0	0	0	0	0	0	0	0	0	0	0		批量查询
玛卡包装设计	0	0	0	0	0	0	0	0	0	0	0	0	0	0	0		批量查询
玛卡精片副作用	0	0	0	0	0	0	0	0	0	0	0	0	0	0	0		批量查询
玛卡益康咀嚼片30	0	0	0	0	0	0	0	0	0	0	0	0	0	0	0		批量查询
玛卡益康咀嚼片12	0	0	0	0	0	0	0	0	0	0	0	0	0	0	0		批量查询
玛卡保健品生产厂家	0	0	0	0	0	0	0	0	0	0	0	0	0	0	0		批量查询
玛卡保健品招商电话	0	0	0	0	0	0	0	0	0	0	0	0	0	0	0		批量查询
玛卡保健品酒	0	0	0	0	0	0	0	0	0	0	0	0	0	0	0		批量查询
玛卡保健品价格	0	0	0	0	0	0	0	0	0	0	0	0	0	0	0		批量查询
玛卡益康咀嚼片 延时	0	0	0	0	0	0	0	0	0	0	0	0	0	0	0		批量查询
玛卡是保健品吗	0	0	0	0	0	0	0	0	0	0	0	0	0	0	0		批量查询
v8男人保健品玛卡	0	0	0	0	0	0	0	0	0	0	0	0	0	0	0		批量查询
保健品玛卡订购价格	0	0	0	0	0	0	0	0	0	0	0	0	0	0	0		批量查询
类似玛卡的保健品	0	0	0	0	0	0	0	0	0	0	0	0	0	0	0		批量查询
玛卡果的吃法	0	0	0	0	0	0	0	0	0	0	0	0	0	0	0		批量查询
玛卡价格是多少钱一斤	0	0	0	0	0	0	0	0	0	0	0	0	0	0	0		批量查询
秘鲁玛卡包装样品	0	0	0	0	0	0	0	0	0	0	0	0	0	0	0		批量查询
玛卡包装图片	0	0	0	0	0	0	0	0	0	0	0	0	0	0	0		批量查询
玛卡女包装	0	0	0	0	0	0	0	0	0	0	0	0	0	0	0		批量查询
玛卡粉怎么吃	0	0	0	0	0	0	0	0	0	0	0	0	0	0	0		批量查询
玛卡粉功效	0	0	0	0	0	0	0	0	0	0	0	0	0	0	0		批量查询
玛卡益康片 咀嚼片	0	0	0	0	0	0	0	0	0	0	0	0	0	0	0		批量查询
玛卡粉如何食用	0	0	0	0	0	0	0	0	0	0	0	0	0	0	0		批量查询
玛卡粉进口	0	0	0	0	0	0	0	0	0	0	0	0	0	0	0		批量查询
中药玛卡的功效与作用	0	0	0	0	0	0	0	0	0	0	0	0	0	0	0		批量查询
玛卡的功效和食用方法	0	0	0	0	0	0	0	0	0	0	0	0	0	0	0		批量查询
玛卡的功效好吗	0	0	0	0	0	0	0	0	0	0	0	0	0	0	0		批量查询
中药玛卡的功效	0	0	0	0	0	0	0	0	0	0	0	0	0	0	0		批量查询
玛卡的功效与作用禁忌	0	0	0	0	0	0	0	0	0	0	0	0	0	0	0		批量查询
丽江玛卡的功效	0	0	0	0	0	0	0	0	0	0	0	0	0	0	0		批量查询
玛卡的功效和食用	0	0	0	0	0	0	0	0	0	0	0	0	0	0	0		批量查询
野生玛卡的功效与作用	0	0	0	0	0	0	0	0	0	0	0	0	0	0	0		批量查询
黑玛卡的功效与作用	0	0	0	0	0	0	0	0	0	0	0	0	0	0	0		批量查询
玛卡泡酒的功效与作用	0	0	0	0	0	0	0	0	0	0	0	0	0	0	0		批量查询
玛卡功效及作用	0	0	0	0	0	0	0	0	0	0	0	0	0	0	0		批量查询
玛卡煲汤的功效与作用	0	0	0	0	0	0	0	0	0	0	0	0	0	0	0		批量查询
玛卡胶囊的作用与功效	0	0	0	0	0	0	0	0	0	0	0	0	0	0	0		批量查询
玛卡种植技术	0	0	0	0	0	0	0	0	0	0	0	0	0	0	0		批量查询
玛卡种植户	0	0	0	0	0	0	0	0	0	0	0	0	0	0	0		批量查询
云南玛卡种植基地	0	0	0	0	0	0	0	0	0	0	0	0	0	0	0		批量查询
云南省曲靖市会泽县玛卡种植基地	0	0	0	0	0	0	0	0	0	0	0	0	0	0	0		批量查询
云南省会泽县高海拔玛卡种植基地	0	0	0	0	0	0	0	0	0	0	0	0	0	0	0		批量查询
新疆种植玛卡	0	0	0	0	0	0	0	0	0	0	0	0	0	0	0		批量查询
会泽草海利达玛卡种植专业合作社	0	0	0	0	0	0	0	0	0	0	0	0	0	0	0		批量查询
丽江玛卡宝月种植基地	0	0	0	0	0	0	0	0	0	0	0	0	0	0	0		批量查询
男人常吃玛卡好吗	0	0	0	0	0	0	0	0	0	0	0	0	0	0	0		批量查询
玛卡男人吃有较吗	0	0	0	0	0	0	0	0	0	0	0	0	0	0	0		批量查询
玛卡对男人的作用	0	0	0	0	0	0	0	0	0	0	0	0	0	0	0		批量查询
玛卡对男人身体好吗	0	0	0	0	0	0	0	0	0	0	0	0	0	0	0		批量查询
男人肾虚保健 玛卡	0	0	0	0	0	0	0	0	0	0	0	0	0	0	0		批量查询
男人可以吃玛卡吗	0	0	0	0	0	0	0	0	0	0	0	0	0	0	0		批量查询
玛卡吃了真的有用吗	0	0	0	0	0	0	0	0	0	0	0	0	0	0	0		批量查询
玛卡片是什么	0	0	0	0	0	0	0	0	0	0	0	0	0	0	0		批量查询
玛卡市场价	0	0	0	0	0	0	0	0	0	0	0	0	0	0	0		批量查询
玛卡片泡水	0	0	0	0	0	0	0	0	0	0	0	0	0	0	0		批量查询
正品玛卡官网	0	0	0	8	56	8	56	0	0	0	0	0	0	0	0		批量查询
玛卡咀嚼片官网	0	0	0	0	0	0	0	0	0	0	0	0	0	0	0		批量查询
玛卡片的作用	0	0	0	0	0	0	0	0	0	0	0	0	0	0	0		批量查询
玛卡果 秘鲁 正品	0	0	0	0	0	0	0	0	0	0	0	0	0	0	0		批量查询
玛卡的功效及吃法	0	0	0	0	0	0	0	0	0	0	0	0	0	0	0		批量查询
玛卡果 新鲜	0	0	0	0	0	0	0	0	0	0	0	0	0	0	0		批量查询
新鲜玛卡的吃法	0	0	0	0	0	0	0	0	0	0	0	0	0	0	0		批量查询
玛卡的最佳吃法	0	0	0	0	0	0	0	0	0	0	0	0	0	0	0		批量查询
云南玛卡吃法	0	0	0	0	0	0	0	0	0	0	0	0	0	0	0		批量查询
丽江人玛卡的吃法	0	0	0	0	0	0	0	0	0	0	0	0	0	0	0		批量查询
上方堂玛卡精片吃法	0	0	0	0	0	0	0	0	0	0	0	0	0	0	0		批量查询
玛卡吃法大全	0	0	0	0	0	0	0	0	0	0	0	0	0	0	0		批量查询
拉摩力拉玛卡保健	0	0	0	0	0	0	0	0	0	0	0	0	0	0	0		批量查询
玛卡干果食用方法	0	0	0	0	0	0	0	0	0	0	0	0	0	0	0		批量查询
玛卡干果货到付款	0	0	0	0	0	0	0	0	0	0	0	0	0	0	0		批量查询
玛卡种植技术视频	0	0	0	0	0	0	0	0	0	0	0	0	0	0	0		批量查询
玛卡种植条件	0	0	0	0	0	0	0	0	0	0	0	0	0	0	0		批量查询
云南丽江玛卡种植基地	0	0	0	0	0	0	0	0	0	0	0	0	0	0	0		批量查询
玛卡种植栽培图片	0	0	0	0	0	0	0	0	0	0	0	0	0	0	0		批量查询
玛卡种植致富节目视频	0	0	0	0	0	0	0	0	0	0	0	0	0	0	0		批量查询
玛卡种植栽培技术	0	0	0	0	0	0	0	0	0	0	0	0	0	0	0		批量查询
中国玛卡种植基地	0	0	0	0	0	0	0	0	0	0	0	0	0	0	0		批量查询
玛卡种植基地	0	0	0	0	0	0	0	0	0	0	0	0	0	0	0		批量查询
玛卡果种子	0	0	0	0	0	0	0	0	0	0	0	0	0	0	0		批量查询
玛卡价格什么药店有卖	0	0	0	0	0	0	0	0	0	0	0	0	0	0	0		批量查询
玛卡果包邮	0	0	0	0	0	0	0	0	0	0	0	0	0	0	0		批量查询
玛卡果 丽江	0	0	0	0	0	0	0	0	0	0	0	0	0	0	0		批量查询
2014云南会泽玛卡价格	0	0	0	0	0	0	0	0	0	0	0	0	0	0	0		批量查询
中国药材市场玛卡价格	0	0	0	0	0	0	0	0	0	0	0	0	0	0	0		批量查询
玛卡果 西藏 正品	0	0	0	0	0	0	0	0	0	0	0	0	0	0	0		批量查询
玛卡果 壮阳	0	0	0	0	0	0	0	0	0	0	0	0	0	0	0		批量查询
玛卡干片真的有效果吗	0	0	0	0	0	0	0	0	0	0	0	0	0	0	0		批量查询
玛卡果 云南	0	0	0	0	0	0	0	0	0	0	0	0	0	0	0		批量查询
拉摩力拉玛卡60片	0	0	0	0	0	0	0	0	0	0	0	0	0	0	0		批量查询
玛卡果 补肾	0	0	0	0	0	0	0	0	0	0	0	0	0	0	0		批量查询
拉摩力拉玛卡片官方网站	0	0	0	0	0	0	0	0	0	0	0	0	0	0	0		批量查询
拉摩力拉玛卡片60片	0	0	0	0	0	0	0	0	0	0	0	0	0	0	0		批量查询
玛米玛卡男童	0	0	0	0	0	0	0	0	0	0	0	0	0	0	0		批量查询
玛米玛卡女童	0	0	0	0	0	0	0	0	0	0	0	0	0	0	0		批量查询
玛米玛卡 女	0	0	0	0	0	0	0	0	0	0	0	0	0	0	0		批量查询
玛米玛卡男	0	0	0	0	0	0	0	0	0	0	0	0	0	0	0		批量查询
玛米玛卡毛衣	0	0	0	0	0	0	0	0	0	0	0	0	0	0	0		批量查询
玛米玛卡羽绒服	0	0	0	0	0	0	0	0	0	0	0	0	0	0	0		批量查询
玛米玛卡男童夏装	0	0	0	0	0	0	0	0	0	0	0	0	0	0	0		批量查询
玛米玛卡男童羽绒服	0	0	0	0	0	0	0	0	0	0	0	0	0	0	0		批量查询
拉摩力拉玛卡片60片正品	0	0	0	0	0	0	0	0	0	0	0	0	0	0	0		批量查询
玛卡果鲜品	0	0	0	0	0	0	0	0	0	0	0	0	0	0	0		批量查询
拉摩力拉玛卡 60	0	0	0	0	0	0	0	0	0	0	0	0	0	0	0		批量查询
拉摩力拉玛卡片 片 玛卡 秘鲁	0	0	0	0	0	0	0	0	0	0	0	0	0	0	0		批量查询
拉摩力拉玛卡胶囊	0	0	0	0	0	0	0	0	0	0	0	0	0	0	0		批量查询
拉摩力拉玛卡丽人	0	0	0	0	0	0	0	0	0	0	0	0	0	0	0		批量查询
拉摩力拉玛卡片正品	0	0	0	0	0	0	0	0	0	0	0	0	0	0	0		批量查询
拉摩力拉玛卡精片	0	0	0	0	0	0	0	0	0	0	0	0	0	0	0		批量查询
拉摩力拉玛卡片30片	0	0	0	0	0	0	0	0	0	0	0	0	0	0	0		批量查询
拉摩力拉玛卡30	0	0	0	0	0	0	0	0	0	0	0	0	0	0	0		批量查询
拉摩力拉玛卡片120片	0	0	0	0	0	0	0	0	0	0	0	0	0	0	0		批量查询
拉摩力拉玛卡片60粒	0	0	0	0	0	0	0	0	0	0	0	0	0	0	0		批量查询
玛卡果服用后图片	0	0	0	0	0	0	0	0	0	0	0	0	0	0	0		批量查询
伽玛卡兹官网	0	0	0	0	0	0	0	0	0	0	0	0	0	0	0		批量查询
伽玛卡兹鱼竿	0	0	0	0	0	0	0	0	0	0	0	0	0	0	0		批量查询
玛卡果 秘鲁	0	0	0	0	0	0	0	0	0	0	0	0	0	0	0		批量查询
伽玛卡兹中文官网	0	0	0	0	0	0	0	0	0	0	0	0	0	0	0		批量查询
伽玛卡兹中国官网	0	0	0	0	0	0	0	0	0	0	0	0	0	0	0		批量查询
玛米玛卡棉衣童装	0	0	0	0	0	0	0	0	0	0	0	0	0	0	0		批量查询
玛米玛卡正品	0	0	0	0	0	0	0	0	0	0	0	0	0	0	0		批量查询
玛米玛卡童装格子衬衫	0	0	0	0	0	0	0	0	0	0	0	0	0	0	0		批量查询
玛米玛卡童装羽绒服	0	0	0	0	0	0	0	0	0	0	0	0	0	0	0		批量查询
玛米玛卡女童2014	0	0	0	0	0	0	0	0	0	0	0	0	0	0	0		批量查询
玛米玛卡2014春男童	0	0	0	0	0	0	0	0	0	0	0	0	0	0	0		批量查询
玛米玛卡女童外套	0	0	0	0	0	0	0	0	0	0	0	0	0	0	0		批量查询
玛米玛卡男童外套	0	0	0	0	0	0	0	0	0	0	0	0	0	0	0		批量查询
玛米玛卡女童夏装	0	0	0	0	0	0	0	0	0	0	0	0	0	0	0		批量查询
玛米玛卡女童春装	0	0	0	0	0	0	0	0	0	0	0	0	0	0	0		批量查询
玛米玛卡女童2014夏	0	0	0	0	0	0	0	0	0	0	0	0	0	0	0		批量查询
玛米玛卡男童衬衫	0	0	0	0	0	0	0	0	0	0	0	0	0	0	0		批量查询
云南鲜玛卡果	0	0	0	0	0	0	0	0	0	0	0	0	0	0	0		批量查询
玛卡莲娜mp3	0	0	0	0	0	0	0	0	0	0	0	0	0	0	0		批量查询
玛卡莲娜原唱	0	0	0	0	0	0	0	0	0	0	0	0	0	0	0		批量查询
玛卡莲娜舞蹈视频	0	0	0	0	0	0	0	0	0	0	0	0	0	0	0		批量查询
玛卡莲娜 歌词	0	0	0	0	0	0	0	0	0	0	0	0	0	0	0		批量查询
中国正宗秘鲁玛卡官网	0	0	0	0	0	0	0	0	0	0	0	0	0	0	0		批量查询
紫玛卡果	0	0	0	0	0	0	0	0	0	0	0	0	0	0	0		批量查询
康博商城秘鲁玛卡官网	0	0	0	0	0	0	0	0	0	0	0	0	0	0	0		批量查询
丽江玛卡果	0	0	0	0	0	0	0	0	0	0	0	0	0	0	0		批量查询
玛卡西尼2013新款	0	0	0	0	0	0	0	0	0	0	0	0	0	0	0		批量查询
玛卡西尼衬衫	0	0	0	0	0	0	0	0	0	0	0	0	0	0	0		批量查询
玛卡金恩懒人享瘦贴片	0	0	0	0	0	0	0	0	0	0	0	0	0	0	0		批量查询
玛卡西尼短袖	0	0	0	0	0	0	0	0	0	0	0	0	0	0	0		批量查询
玛卡西尼2014	0	0	0	0	0	0	0	0	0	0	0	0	0	0	0		批量查询
玛卡西尼正品男装	0	0	0	0	0	0	0	0	0	0	0	0	0	0	0		批量查询
玛卡西尼裤子	0	0	0	0	0	0	0	0	0	0	0	0	0	0	0		批量查询
玛卡西尼 西服	0	0	0	0	0	0	0	0	0	0	0	0	0	0	0		批量查询
玛卡西尼2014代购	0	0	0	0	0	0	0	0	0	0	0	0	0	0	0		批量查询
玛卡西尼夹克	0	0	0	0	0	0	0	0	0	0	0	0	0	0	0		批量查询
玛卡西尼t恤	0	0	0	0	0	0	0	0	0	0	0	0	0	0	0		批量查询
玛卡西尼风衣	0	0	0	0	0	0	0	0	0	0	0	0	0	0	0		批量查询
玛卡果 干片	0	0	0	0	0	0	0	0	0	0	0	0	0	0	0		批量查询
松古树美玛卡怎么样	0	0	0	0	0	0	0	0	0	0	0	0	0	0	0		批量查询
轩庆玛卡怎么样	0	0	0	0	0	0	0	0	0	0	0	0	0	0	0		批量查询
极卡纯玛卡怎么样	0	0	0	0	0	0	0	0	0	0	0	0	0	0	0		批量查询
玛卡怎么样吃多少见效	0	0	0	0	0	0	0	0	0	0	0	0	0	0	0		批量查询
淘宝上卖的玛卡怎么样	0	0	0	0	0	0	0	0	0	0	0	0	0	0	0		批量查询
活力达玛卡怎么样	0	0	0	0	0	0	0	0	0	0	0	0	0	0	0		批量查询
丽彩芳姿玛卡怎么样	0	0	0	0	0	0	0	0	0	0	0	0	0	0	0		批量查询
台湾玛卡威刚	0	0	0	0	0	0	0	0	0	0	0	0	0	0	0		批量查询
进口玛卡果	0	0	0	0	0	0	0	0	0	0	0	0	0	0	0		批量查询
玛卡湿巾有什么用	0	0	0	0	0	0	0	0	0	0	0	0	0	0	0		批量查询
秘鲁玛卡黑果	0	0	0	0	0	0	0	0	0	0	0	0	0	0	0		批量查询
新疆玛卡哪有卖	0	0	0	0	0	0	0	0	0	0	0	0	0	0	0		批量查询
新鲜玛卡哪有卖	0	0	0	0	0	0	0	0	0	0	0	0	0	0	0		批量查询
天津哪有卖秘鲁玛卡的	0	0	0	0	0	0	0	0	0	0	0	0	0	0	0		批量查询
北京哪有卖秘鲁玛卡	0	0	0	0	0	0	0	0	0	0	0	0	0	0	0		批量查询
西安哪有卖玛卡的	0	0	0	0	0	0	0	0	0	0	0	0	0	0	0		批量查询
上海哪有卖玛卡果 的	0	0	0	0	0	0	0	0	0	0	0	0	0	0	0		批量查询
吉林市哪有卖玛卡的	0	0	0	0	0	0	0	0	0	0	0	0	0	0	0		批量查询
常熟哪有玛卡胶囊卖	0	0	0	0	0	0	0	0	0	0	0	0	0	0	0		批量查询
玛米玛卡童装贴牌	0	0	0	0	0	0	0	0	0	0	0	0	0	0	0		批量查询
玛米玛卡momoco童装生产商	0	0	0	0	0	0	0	0	0	0	0	0	0	0	0		批量查询
玛米玛卡女童装	0	0	0	0	0	0	0	0	0	0	0	0	0	0	0		批量查询
春款 童装玛米玛卡	0	0	0	0	0	0	0	0	0	0	0	0	0	0	0		批量查询
正品玛米玛卡小童童装	0	0	0	0	0	0	0	0	0	0	0	0	0	0	0		批量查询
专柜玛米玛卡童装中大童女童呢子	0	0	0	0	0	0	0	0	0	0	0	0	0	0	0		批量查询
玛米玛卡童装男童	0	0	0	0	0	0	0	0	0	0	0	0	0	0	0		批量查询
玛米玛卡童装女童	0	0	0	0	0	0	0	0	0	0	0	0	0	0	0		批量查询
玛卡果提取	0	0	0	0	0	0	0	0	0	0	0	0	0	0	0		批量查询
玛米玛卡童装男童夏	0	0	0	0	0	0	0	0	0	0	0	0	0	0	0		批量查询
玛米玛卡童装女外套	0	0	0	0	0	0	0	0	0	0	0	0	0	0	0		批量查询
玛米玛卡童装女童夏	0	0	0	0	0	0	0	0	0	0	0	0	0	0	0		批量查询
玛米玛卡童装男	0	0	0	0	0	0	0	0	0	0	0	0	0	0	0		批量查询
玛米玛卡童装公主裙	0	0	0	0	0	0	0	0	0	0	0	0	0	0	0		批量查询
玛米玛卡童装女	0	0	0	0	0	0	0	0	0	0	0	0	0	0	0		批量查询
玛米玛卡童装正品女	0	0	0	0	0	0	0	0	0	0	0	0	0	0	0		批量查询
玛卡亚米全球物流	0	0	0	0	0	0	0	0	0	0	0	0	0	0	0		批量查询
玛卡亚米物流	0	0	0	0	0	0	0	0	0	0	0	0	0	0	0		批量查询
玛卡亚米 百度百科	0	0	0	0	0	0	0	0	0	0	0	0	0	0	0		批量查询
上海玛卡亚米	0	0	0	0	0	0	0	0	0	0	0	0	0	0	0		批量查询
伽玛卡兹爆炸钩	0	0	0	0	0	0	0	0	0	0	0	0	0	0	0		批量查询
玛卡果适应哪里种植	0	0	0	0	0	0	0	0	0	0	0	0	0	0	0		批量查询
伽玛卡兹鱼钩 进口	0	0	0	0	0	0	0	0	0	0	0	0	0	0	0		批量查询
伽玛卡兹 矶钓竿	0	0	0	0	0	0	0	0	0	0	0	0	0	0	0		批量查询
伽玛卡兹鲤鱼竿	0	0	0	0	0	0	0	0	0	0	0	0	0	0	0		批量查询
伽玛卡兹 并继鱼竿	0	0	0	0	0	0	0	0	0	0	0	0	0	0	0		批量查询
伽玛卡兹凌波	0	0	0	0	0	0	0	0	0	0	0	0	0	0	0		批量查询
伽玛卡兹伽玛鲤	0	0	0	0	0	0	0	0	0	0	0	0	0	0	0		批量查询
伽玛卡兹鱼钩 进口 袖	0	0	0	0	0	0	0	0	0	0	0	0	0	0	0		批量查询
拉摩力拉玛卡官方网站	0	0	0	0	0	0	0	0	0	0	0	0	0	0	0		批量查询
拉摩力拉玛卡代理	0	0	0	0	0	0	0	0	0	0	0	0	0	0	0		批量查询
玛卡营养胶囊	0	0	0	0	0	0	0	0	0	0	0	0	0	0	0		批量查询
拉摩力拉玛卡效果如何	0	0	0	0	0	0	0	0	0	0	0	0	0	0	0		批量查询
拉摩力拉玛卡招商	0	0	0	0	0	0	0	0	0	0	0	0	0	0	0		批量查询
拉摩力拉玛卡防伪查询	0	0	0	0	0	0	0	0	0	0	0	0	0	0	0		批量查询
拉摩力拉玛卡食用方法	0	0	0	0	0	0	0	0	0	0	0	0	0	0	0		批量查询
拉摩力拉玛卡真假	0	0	0	0	0	0	0	0	0	0	0	0	0	0	0		批量查询
玛米玛卡童装加盟官网	0	0	0	0	0	0	0	0	0	0	0	0	0	0	0		批量查询
玛米玛卡童装加盟骗局	0	0	0	0	0	0	0	0	0	0	0	0	0	0	0		批量查询
玛卡泡酒配方大全	0	0	0	0	0	0	0	0	0	0	0	0	0	0	0		批量查询
玛卡威刚片	0	0	0	0	0	0	0	0	0	0	0	0	0	0	0		批量查询
野生玛卡价格	0	0	0	0	0	0	0	0	0	0	0	0	0	0	0		批量查询
玛卡一天吃多少	0	0	0	0	0	0	0	0	0	0	0	0	0	0	0		批量查询
丽江玛卡副作用	0	0	0	0	0	0	0	0	0	0	0	0	0	0	0		批量查询
黄金玛卡副作用	0	0	0	0	0	0	0	0	0	0	0	0	0	0	0		批量查询
秘鲁maca玛卡副作用	0	0	0	0	0	0	0	0	0	0	0	0	0	0	0		批量查询
玛咖精片玛卡的副作用	0	0	0	0	0	0	0	0	0	0	0	0	0	0	0		批量查询
玛卡西尼在什么档次	0	0	0	0	0	0	0	0	0	0	0	0	0	0	0		批量查询
玛卡益康咀嚼片多少钱	0	0	0	0	0	0	0	0	0	0	0	0	0	0	0		批量查询
武汉玛卡益康咀嚼片	0	0	0	0	0	0	0	0	0	0	0	0	0	0	0		批量查询
玛卡西尼和杰克琼斯	0	0	0	0	0	0	0	0	0	0	0	0	0	0	0		批量查询
玛卡西尼2014风衣	0	0	0	0	0	0	0	0	0	0	0	0	0	0	0		批量查询
玛卡 延时 湿巾	0	0	0	0	0	0	0	0	0	0	0	0	0	0	0		批量查询
玛卡泡酒比例	0	0	0	0	0	0	0	0	0	0	0	0	0	0	0		批量查询
玛卡泡酒	0	0	0	0	0	0	0	0	0	0	0	0	0	0	0		批量查询
玛卡怎么泡酒	0	0	0	0	0	0	0	0	0	0	0	0	0	0	0		批量查询
玛卡片怎么吃	0	0	0	0	0	0	0	0	0	0	0	0	0	0	0		批量查询
服用玛卡有副作用吗	0	0	0	0	0	0	0	0	0	0	0	0	0	0	0		批量查询
玛卡益康咀嚼片有用么	0	0	0	0	0	0	0	0	0	0	0	0	0	0	0		批量查询
金玛卡有副作用吗	0	0	0	0	0	0	0	0	0	0	0	0	0	0	0		批量查询
玛卡片怎么服用	0	0	0	0	0	0	0	0	0	0	0	0	0	0	0		批量查询
玛米玛卡momoco童装	0	0	0	0	0	0	0	0	0	0	0	0	0	0	0		批量查询
玛卡片在秘鲁多少钱	0	0	0	0	0	0	0	0	0	0	0	0	0	0	0		批量查询
玛卡瑞纳 吉他谱	0	0	0	0	0	0	0	0	0	0	0	0	0	0	0		批量查询
玛卡瑞纳 歌词	0	0	0	0	0	0	0	0	0	0	0	0	0	0	0		批量查询
玛卡瑞纳 海龟先生	0	0	0	0	0	0	0	0	0	0	0	0	0	0	0		批量查询
玛卡瑞纳舞	0	0	0	0	0	0	0	0	0	0	0	0	0	0	0		批量查询
玛米玛卡童装2013棉服	0	0	0	0	0	0	0	0	0	0	0	0	0	0	0		批量查询
玛米玛卡童装2013秋装	0	0	0	0	0	0	0	0	0	0	0	0	0	0	0		批量查询
伽玛卡兹鱼竿大全	0	0	0	0	0	0	0	0	0	0	0	0	0	0	0		批量查询
伽玛卡兹鲤x鱼竿大全	0	0	0	0	0	0	0	0	0	0	0	0	0	0	0		批量查询
伽玛卡兹矶钓鱼竿专卖	0	0	0	0	0	0	0	0	0	0	0	0	0	0	0		批量查询
伽玛卡兹鱼钩批发	0	0	0	0	0	0	0	0	0	0	0	0	0	0	0		批量查询
广州伽玛卡兹官网	0	0	0	0	0	0	0	0	0	0	0	0	0	0	0		批量查询
玛卡片咽下去	0	0	0	0	0	0	0	0	0	0	0	0	0	0	0		批量查询
安第斯玛卡片	0	0	0	0	0	0	0	0	0	0	0	0	0	0	0		批量查询
玛米玛卡童装加盟条件	0	0	0	0	0	0	0	0	0	0	0	0	0	0	0		批量查询
玛卡真假查询	0	0	0	0	0	0	0	0	0	0	0	0	0	0	0		批量查询
野口补肾壮阳玛咖 玛卡营养胶囊	0	0	0	0	0	0	0	0	0	0	0	0	0	0	0		批量查询
野口玛卡营养胶囊	0	0	0	0	0	0	0	0	0	0	0	0	0	0	0		批量查询
玛卡复合营养胶囊	0	0	0	0	0	0	0	0	0	0	0	0	0	0	0		批量查询
玛卡金恩左旋360	0	0	0	0	0	0	0	0	0	0	0	0	0	0	0		批量查询
优式玛卡威刚	0	0	0	0	0	0	0	0	0	0	0	0	0	0	0		批量查询
玛卡益康正品	0	0	0	0	0	0	0	0	0	0	0	0	0	0	0		批量查询
玛卡威刚给力1号	0	0	0	0	0	0	0	0	0	0	0	0	0	0	0		批量查询
玛卡威刚代发货	0	0	0	0	0	0	0	0	0	0	0	0	0	0	0		批量查询
秘鲁玛卡片多少钱	0	0	0	0	0	0	0	0	0	0	0	0	0	0	0		批量查询
玛卡湿巾 makayk	0	0	0	0	0	0	0	0	0	0	0	0	0	0	0		批量查询
玛卡湿巾是什么	0	0	0	0	0	0	0	0	0	0	0	0	0	0	0		批量查询
黑玛卡复合营养片	0	0	0	0	0	0	0	0	0	0	0	0	0	0	0		批量查询
玛卡秘鲁 片剂	0	0	0	0	0	0	0	0	0	0	0	0	0	0	0		批量查询
玛米玛卡momoco官网	0	0	0	0	0	0	0	0	0	0	0	0	0	0	0		批量查询
新鲜玛卡怎么吃	0	0	0	0	0	0	0	0	0	0	0	0	0	0	0		批量查询
新鲜玛卡怎么吃效果好	0	0	0	0	0	0	0	0	0	0	0	0	0	0	0		批量查询
丽江新鲜玛卡怎么吃	0	0	0	0	0	0	0	0	0	0	0	0	0	0	0		批量查询
丽江玛卡怎么吃	0	0	0	0	0	0	0	0	0	0	0	0	0	0	0		批量查询
玛卡怎么吃最好	0	0	0	0	0	0	0	0	0	0	0	0	0	0	0		批量查询
丽江玛卡片正品	0	0	0	0	0	0	0	0	0	0	0	0	0	0	0		批量查询
云南玛卡片 正品	0	0	0	0	0	0	0	0	0	0	0	0	0	0	0		批量查询
玛咖片 玛卡片正品	0	0	0	0	0	0	0	0	0	0	0	0	0	0	0		批量查询
拉摩力拉正品玛卡片	0	0	0	0	0	0	0	0	0	0	0	0	0	0	0		批量查询
玛卡片女 正品	0	0	0	0	0	0	0	0	0	0	0	0	0	0	0		批量查询
玛卡片 正品 男性	0	0	0	0	0	0	0	0	0	0	0	0	0	0	0		批量查询
正品享硬玛卡片	0	0	0	0	0	0	0	0	0	0	0	0	0	0	0		批量查询
秘鲁 正品 玛卡片 干果	0	0	0	0	0	0	0	0	0	0	0	0	0	0	0		批量查询
玛卡的功效副作用	0	0	0	0	0	0	0	0	0	0	0	0	0	0	0		批量查询
玛卡maca真的有效果吗	0	0	0	0	0	0	0	0	0	0	0	0	0	0	0		批量查询
吃玛卡真的效果很好么	0	0	0	0	0	0	0	0	0	0	0	0	0	0	0		批量查询
玛卡的效果是真的吗	0	0	0	0	0	0	0	0	0	0	0	0	0	0	0		批量查询
玛卡是真的有效果吗	0	0	0	0	0	0	0	0	0	0	0	0	0	0	0		批量查询
玛卡真的有增大效果吗	0	0	0	0	0	0	0	0	0	0	0	0	0	0	0		批量查询
玛卡片 代加工	0	0	0	0	0	0	0	0	0	0	0	0	0	0	0		批量查询
玛卡的功效是什么	0	0	0	0	0	0	0	0	0	0	0	0	0	0	0		批量查询
玛卡的功效与作用及食用方法	0	0	0	0	0	0	0	0	0	0	0	0	0	0	0		批量查询
玛卡益康咖啡	0	0	0	0	0	0	0	0	0	0	0	0	0	0	0		批量查询
紫玛卡的功效	0	0	0	0	0	0	0	0	0	0	0	0	0	0	0		批量查询
玛卡多少钱一斤	0	0	0	0	0	0	0	0	0	0	0	0	0	0	0		批量查询
玛卡种子多少钱一斤	0	0	0	0	0	0	0	0	0	0	0	0	0	0	0		批量查询
丽江的玛卡多少钱一斤	0	0	0	0	0	0	0	0	0	0	0	0	0	0	0		批量查询
玛卡的种植多少钱一斤	0	0	0	0	0	0	0	0	0	0	0	0	0	0	0		批量查询
新鲜玛卡多少钱一斤	0	0	0	0	0	0	0	0	0	0	0	0	0	0	0		批量查询
国宝玛卡多少钱一斤	0	0	0	0	0	0	0	0	0	0	0	0	0	0	0		批量查询
天然玛卡多少钱一斤	0	0	0	0	0	0	0	0	0	0	0	0	0	0	0		批量查询
拉摩力maca秘鲁玛卡片	0	0	0	0	0	0	0	0	0	0	0	0	0	0	0		批量查询
秘鲁野生玛卡 玛咖干果片	0	0	0	0	0	0	0	0	0	0	0	0	0	0	0		批量查询
绿标防伪拉摩力maca秘鲁玛卡片	0	0	0	0	0	0	0	0	0	0	0	0	0	0	0		批量查询
玛卡玛咖干片	0	0	0	0	0	0	0	0	0	0	0	0	0	0	0		批量查询
玛卡营养胶囊有用吗	0	0	0	0	0	0	0	0	0	0	0	0	0	0	0		批量查询
玛卡粉营养胶囊	0	0	0	0	0	0	0	0	0	0	0	0	0	0	0		批量查询
玛卡胶囊 补肾	0	0	0	0	0	0	0	0	0	0	0	0	0	0	0		批量查询
秘鲁玛卡片 30	0	0	0	0	0	0	0	0	0	0	0	0	0	0	0		批量查询
秘鲁原装进口玛卡片	0	0	0	0	0	0	0	0	0	0	0	0	0	0	0		批量查询
秘鲁玛卡玛卡片	0	0	0	0	0	0	0	0	0	0	0	0	0	0	0		批量查询
秘鲁原装玛卡片maca	0	0	0	0	0	0	0	0	0	0	0	0	0	0	0		批量查询
玛卡片秘鲁正品精片	0	0	0	0	0	0	0	0	0	0	0	0	0	0	0		批量查询
拉摩力拉牌玛卡片60片	0	0	0	0	0	0	0	0	0	0	0	0	0	0	0		批量查询
拉摩力拉牌玛卡片 60	0	0	0	0	0	0	0	0	0	0	0	0	0	0	0		批量查询
玛卡干果片 伟持久哥	0	0	0	0	0	0	0	0	0	0	0	0	0	0	0		批量查询
玛卡秘鲁正品干果片	0	0	0	0	0	0	0	0	0	0	0	0	0	0	0		批量查询
玛卡 玛卡干果 玛咖片	0	0	0	0	0	0	0	0	0	0	0	0	0	0	0		批量查询
黄玛卡干果 干果片	0	0	0	0	0	0	0	0	0	0	0	0	0	0	0		批量查询
秘鲁进口玛卡干果片	0	0	0	0	0	0	0	0	0	0	0	0	0	0	0		批量查询
男用补肾 玛卡干果片	0	0	0	0	0	0	0	0	0	0	0	0	0	0	0		批量查询
紫玛卡干果片	0	0	0	0	0	0	0	0	0	0	0	0	0	0	0		批量查询
黑玛卡干果片	0	0	0	0	0	0	0	0	0	0	0	0	0	0	0		批量查询
丽江 玛卡干果片	0	0	0	0	0	0	0	0	0	0	0	0	0	0	0		批量查询
秘鲁代购 玛卡干果片	0	0	0	0	0	0	0	0	0	0	0	0	0	0	0		批量查询
玛卡胶囊 延时	0	0	0	0	0	0	0	0	0	0	0	0	0	0	0		批量查询
玛卡枸杞大枣泡酒配方	0	0	0	0	0	0	0	0	0	0	0	0	0	0	0		批量查询
玛卡如何泡酒及配方	0	0	0	0	0	0	0	0	0	0	0	0	0	0	0		批量查询
谁知道玛卡泡酒的配方	0	0	0	0	0	0	0	0	0	0	0	0	0	0	0		批量查询
玛卡干果枸杞泡酒配方	0	0	0	0	0	0	0	0	0	0	0	0	0	0	0		批量查询
玛卡泡酒怎么泡	0	0	0	0	0	0	0	0	0	0	0	0	0	0	0		批量查询
拉摩力拉牌 玛卡片 30	0	0	0	0	0	0	0	0	0	0	0	0	0	0	0		批量查询
tiangang玛咖片 玛卡	0	0	0	0	0	0	0	0	0	0	0	0	0	0	0		批量查询
玛卡片 玛咖干	0	0	0	0	0	0	0	0	0	0	0	0	0	0	0		批量查询
玛卡片怎么吃吸收快	0	0	0	0	0	0	0	0	0	0	0	0	0	0	0		批量查询
玛卡片女人能吃吗	0	0	0	0	0	0	0	0	0	0	0	0	0	0	0		批量查询
玛卡片一般吃多长时间	0	0	0	0	0	0	0	0	0	0	0	0	0	0	0		批量查询
年轻人吃玛卡片好不好	0	0	0	0	0	0	0	0	0	0	0	0	0	0	0		批量查询
吃玛卡片上火吗	0	0	0	0	0	0	0	0	0	0	0	0	0	0	0		批量查询
玛卡片干吃是什么味道	0	0	0	0	0	0	0	0	0	0	0	0	0	0	0		批量查询
年轻人能不能吃玛卡片	0	0	0	0	0	0	0	0	0	0	0	0	0	0	0		批量查询
玛咖压片糖果 玛卡	0	0	0	0	0	0	0	0	0	0	0	0	0	0	0		批量查询
un优恩玛咖片 玛卡	0	0	0	0	0	0	0	0	0	0	0	0	0	0	0		批量查询
玛卡玛咖片秘鲁	0	0	0	0	0	0	0	0	0	0	0	0	0	0	0		批量查询
玛卡正品干片玛咖片	0	0	0	0	0	0	0	0	0	0	0	0	0	0	0		批量查询
松古树美玛咖片玛卡	0	0	0	0	0	0	0	0	0	0	0	0	0	0	0		批量查询
玛卡胶囊 原装进口	0	0	0	0	0	0	0	0	0	0	0	0	0	0	0		批量查询
丽江玛卡的真假辨别	0	0	0	0	0	0	0	0	0	0	0	0	0	0	0		批量查询
玛卡官网真假辨别	0	0	0	0	0	0	0	0	0	0	0	0	0	0	0		批量查询
如何辨别玛卡真假	0	0	0	0	0	0	0	0	0	0	0	0	0	0	0		批量查询
玛卡胶囊 日	0	0	0	0	0	0	0	0	0	0	0	0	0	0	0		批量查询
上海秘鲁玛卡真假识别	0	0	0	0	0	0	0	0	0	0	0	0	0	0	0		批量查询
玛卡益康咀嚼片真假	0	0	0	0	0	0	0	0	0	0	0	0	0	0	0		批量查询
玛卡胶囊 保健品	0	0	0	0	0	0	0	0	0	0	0	0	0	0	0		批量查询
玛卡益康片真假辨别	0	0	0	0	0	0	0	0	0	0	0	0	0	0	0		批量查询
云南丽江玛咖玛卡片	0	0	0	0	0	0	0	0	0	0	0	0	0	0	0		批量查询
丽江玛咖玛卡片	0	0	0	0	0	0	0	0	0	0	0	0	0	0	0		批量查询
优恩玛卡片 玛咖	0	0	0	0	0	0	0	0	0	0	0	0	0	0	0		批量查询
maca秘鲁玛卡片	0	0	0	0	0	0	0	0	0	0	0	0	0	0	0		批量查询
玛卡片 maca玛卡胶囊	0	0	0	0	0	0	0	0	0	0	0	0	0	0	0		批量查询
玛卡片 正品批发	0	0	0	0	0	0	0	0	0	0	0	0	0	0	0		批量查询
玛卡怎样吃效果好	0	0	0	0	0	0	0	0	0	0	0	0	0	0	0		批量查询
玛卡什么时候吃效果好	0	0	0	0	0	0	0	0	0	0	0	0	0	0	0		批量查询
玛卡粉怎么吃效果好	0	0	0	0	0	0	0	0	0	0	0	0	0	0	0		批量查询
拉摩力拉 玛卡片 30片	0	0	0	0	0	0	0	0	0	0	0	0	0	0	0		批量查询
中药玛卡干果价格	0	0	0	0	0	0	0	0	0	0	0	0	0	0	0		批量查询
中药玛卡的食用方法	0	0	0	0	0	0	0	0	0	0	0	0	0	0	0		批量查询
中药玛卡多少钱1公斤	0	0	0	0	0	0	0	0	0	0	0	0	0	0	0		批量查询
中药玛卡图片	0	0	0	0	0	0	0	0	0	0	0	0	0	0	0		批量查询
中药玛卡怎么吃	0	0	0	0	0	0	0	0	0	0	0	0	0	0	0		批量查询
玛卡是中药吗	0	0	0	0	0	0	0	0	0	0	0	0	0	0	0		批量查询
玛卡干片高原玛卡片	0	0	0	0	0	0	0	0	0	0	0	0	0	0	0		批量查询
玛卡片有副作用吗	0	0	0	0	0	0	0	0	0	0	0	0	0	0	0		批量查询
玛卡冻干片	0	0	0	0	0	0	0	0	0	0	0	0	0	0	0		批量查询
玛卡片剂加工	0	0	0	0	0	0	0	0	0	0	0	0	0	0	0		批量查询
正品秘鲁玛卡片	0	0	0	0	0	0	0	0	0	0	0	0	0	0	0		批量查询
秘鲁正品玛卡片官网	0	0	0	0	0	0	0	0	0	0	0	0	0	0	0		批量查询
玛卡种植环境	0	0	0	0	0	0	0	0	0	0	0	0	0	0	0		批量查询
丽江玛卡种植	0	0	0	0	0	0	0	0	0	0	0	0	0	0	0		批量查询
拉摩力拉玛玛卡片	0	0	0	0	0	0	0	0	0	0	0	0	0	0	0		批量查询
合玛卡片批发	0	0	0	0	0	0	0	0	0	0	0	0	0	0	0		批量查询
黑玛卡价格	0	0	0	0	0	0	0	0	0	0	0	0	0	0	0		批量查询
玛卡胶囊 日本进口	0	0	0	0	0	0	0	0	0	0	0	0	0	0	0		批量查询
玛卡胶囊 日本	0	0	0	0	0	0	0	0	0	0	0	0	0	0	0		批量查询
玛卡胶囊 增大	0	0	0	0	0	0	0	0	0	0	0	0	0	0	0		批量查询
玛卡是什么 价格	0	0	0	0	0	0	0	0	0	0	0	0	0	0	0		批量查询
玛卡是什么植物	0	0	0	0	0	0	0	0	0	0	0	0	0	0	0		批量查询
玛卡是什么样子	0	0	0	0	0	0	0	0	0	0	0	0	0	0	0		批量查询
玛卡胶囊云南	0	0	0	0	0	0	0	0	0	0	0	0	0	0	0		批量查询
玛卡是什么味道	0	0	0	0	0	0	0	0	0	0	0	0	0	0	0		批量查询
玛卡胶囊正品	0	0	0	0	0	0	0	0	0	0	0	0	0	0	0		批量查询
玛卡是什么意思	0	0	0	0	0	0	0	0	0	0	0	0	0	0	0		批量查询
云南玛卡是什么	0	0	0	0	0	0	0	0	0	0	0	0	0	0	0		批量查询
中药玛卡是什么	0	0	0	0	0	0	0	0	0	0	0	0	0	0	0		批量查询
秘鲁玛卡片是假的	0	0	0	0	0	0	0	0	0	0	0	0	0	0	0		批量查询
秘鲁玛卡片副作用	0	0	0	0	0	0	0	0	0	0	0	0	0	0	0		批量查询
正宗秘鲁玛卡片	0	0	0	0	0	0	0	0	0	0	0	0	0	0	0		批量查询
秘鲁玛卡片管用吗	0	0	0	0	0	0	0	0	0	0	0	0	0	0	0		批量查询
有谁服用过秘鲁玛卡片	0	0	0	0	0	0	0	0	0	0	0	0	0	0	0		批量查询
真正秘鲁玛卡片	0	0	0	0	0	0	0	0	0	0	0	0	0	0	0		批量查询
秘鲁玛卡片昆明销售点	0	0	0	0	0	0	0	0	0	0	0	0	0	0	0		批量查询
秘鲁玛卡片有效吗	0	0	0	0	0	0	0	0	0	0	0	0	0	0	0		批量查询
秘鲁男人吃玛卡果图片	0	0	0	0	0	0	0	0	0	0	0	0	0	0	0		批量查询
拉摩力拉牌玛卡片效果	0	0	0	0	0	0	0	0	0	0	0	0	0	0	0		批量查询
拉摩力拉牌玛卡片官网	0	0	0	0	0	0	0	0	0	0	0	0	0	0	0		批量查询
拉摩力拉牌玛卡片价格	0	0	0	0	0	0	0	0	0	0	0	0	0	0	0		批量查询
拉摩力拉牌玛卡片上海	0	0	0	0	0	0	0	0	0	0	0	0	0	0	0		批量查询
拉摩力拉牌玛卡片功效	0	0	0	0	0	0	0	0	0	0	0	0	0	0	0		批量查询
拉摩力拉牌玛卡片相片	0	0	0	0	0	0	0	0	0	0	0	0	0	0	0		批量查询
拉摩力拉牌玛卡片真假	0	0	0	0	0	0	0	0	0	0	0	0	0	0	0		批量查询
玛卡片玛咖有副作用吗	0	0	0	0	0	0	0	0	0	0	0	0	0	0	0		批量查询
古之极玛咖玛卡片	0	0	0	0	0	0	0	0	0	0	0	0	0	0	0		批量查询
松古树美 玛卡片玛咖	0	0	0	0	0	0	0	0	0	0	0	0	0	0	0		批量查询
玛卡果图片	0	0	0	0	0	0	0	0	0	0	0	0	0	0	0		批量查询
秘鲁进口玛卡片防伪	0	0	0	0	0	0	0	0	0	0	0	0	0	0	0		批量查询
秘鲁进口玛卡片	0	0	0	0	0	0	0	0	0	0	0	0	0	0	0		批量查询
玛卡片新闻30分	0	0	0	0	0	0	0	0	0	0	0	0	0	0	0		批量查询
拉摩力拉玛卡片怎么样	0	0	0	0	0	0	0	0	0	0	0	0	0	0	0		批量查询
玛卡干片 干果如何吃	0	0	0	0	0	0	0	0	0	0	0	0	0	0	0		批量查询
玛卡果的食用方法	0	0	0	0	0	0	0	0	0	0	0	0	0	0	0		批量查询
拉摩力拉玛卡片怎么吃	0	0	0	0	0	0	0	0	0	0	0	0	0	0	0		批量查询
拉摩力拉玛卡片价格	0	0	0	0	0	0	0	0	0	0	0	0	0	0	0		批量查询
拉摩力拉玛卡服用方法	0	0	0	0	0	0	0	0	0	0	0	0	0	0	0		批量查询
悦色红蓝的拉摩力拉玛卡	0	0	0	0	0	0	0	0	0	0	0	0	0	0	0		批量查询
玛卡果种植	0	0	0	0	0	0	0	0	0	0	0	0	0	0	0		批量查询
玛米玛卡家具	0	0	0	0	0	0	0	0	0	0	0	0	0	0	0		批量查询
玛卡片批发价格	0	0	0	0	0	0	0	0	0	0	0	0	0	0	0		批量查询
玛卡牌益康咀嚼片	0	0	0	0	0	0	0	0	0	0	0	0	0	0	0		批量查询
天然玛卡益康咀嚼片	0	0	0	0	0	0	0	0	0	0	0	0	0	0	0		批量查询
maca玛卡益康咀嚼片	0	0	0	0	0	0	0	0	0	0	0	0	0	0	0		批量查询
玛卡益康咀嚼片真有效	0	0	0	0	0	0	0	0	0	0	0	0	0	0	0		批量查询
秘鲁玛卡女人能吃吗	0	0	0	0	0	0	0	0	0	0	0	0	0	0	0		批量查询
轩庆 丽江 玛卡	0	0	0	0	0	0	0	0	0	0	0	0	0	0	0		批量查询
玛卡片真的有增大效果	0	0	0	0	0	0	0	0	0	0	0	0	0	0	0		批量查询
玛卡片真的那么神奇吗	0	0	0	0	0	0	0	0	0	0	0	0	0	0	0		批量查询
玛卡片是真的吗	0	0	0	0	0	0	0	0	0	0	0	0	0	0	0		批量查询
玛卡片真的假的	0	0	0	0	0	0	0	0	0	0	0	0	0	0	0		批量查询
从那能买到真玛卡片	0	0	0	0	0	0	0	0	0	0	0	0	0	0	0		批量查询
玛卡片有效果吗	0	0	0	0	0	0	0	0	0	0	0	0	0	0	0		批量查询
玛卡片效果	0	0	0	0	0	0	0	0	0	0	0	0	0	0	0		批量查询
新鲜玛卡果500	0	0	0	0	0	0	0	0	0	0	0	0	0	0	0		批量查询
新鲜紫玛卡果	0	0	0	0	0	0	0	0	0	0	0	0	0	0	0		批量查询
秘鲁玛卡果 新鲜	0	0	0	0	0	0	0	0	0	0	0	0	0	0	0		批量查询
摩力拉牌玛卡片危害	0	0	0	0	0	0	0	0	0	0	0	0	0	0	0		批量查询
丽江玛卡片价格	0	0	0	0	0	0	0	0	0	0	0	0	0	0	0		批量查询
国产玛卡片的价格	0	0	0	0	0	0	0	0	0	0	0	0	0	0	0		批量查询
玛卡新鲜果	0	0	0	0	0	0	0	0	0	0	0	0	0	0	0		批量查询
玛咖干果 丽江玛卡果	0	0	0	0	0	0	0	0	0	0	0	0	0	0	0		批量查询
玛咖鲜果 丽江玛卡果	0	0	0	0	0	0	0	0	0	0	0	0	0	0	0		批量查询
丽江玛卡果 马卡粉	0	0	0	0	0	0	0	0	0	0	0	0	0	0	0		批量查询
丽江紫玛卡果	0	0	0	0	0	0	0	0	0	0	0	0	0	0	0		批量查询
丽江黄玛卡果	0	0	0	0	0	0	0	0	0	0	0	0	0	0	0		批量查询
丽江玛卡果 500克	0	0	0	0	0	0	0	0	0	0	0	0	0	0	0		批量查询
玛卡片要吃多久	0	0	0	0	0	0	0	0	0	0	0	0	0	0	0		批量查询
伽玛卡兹路亚竿	0	0	0	0	0	0	0	0	0	0	0	0	0	0	0		批量查询
伽玛卡兹鱼钩进口	0	0	0	0	0	0	0	0	0	0	0	0	0	0	0		批量查询
玛卡 武汉	0	0	0	0	0	0	0	0	0	0	0	0	0	0	0		批量查询
秘鲁进口玛卡玛咖果	0	0	0	0	0	0	0	0	0	0	0	0	0	0	0		批量查询
进口秘鲁玛卡果	0	0	0	0	0	0	0	0	0	0	0	0	0	0	0		批量查询
秘鲁maca原装玛卡果	0	0	0	0	0	0	0	0	0	0	0	0	0	0	0		批量查询
黄金玛卡有效果吗	0	0	0	0	0	0	0	0	0	0	0	0	0	0	0		批量查询
玛卡果怎样吃效果好	0	0	0	0	0	0	0	0	0	0	0	0	0	0	0		批量查询
玛卡果的批发价格	0	0	0	0	0	0	0	0	0	0	0	0	0	0	0		批量查询
玛卡胶囊诺奥	0	0	0	0	0	0	0	0	0	0	0	0	0	0	0		批量查询
干片 玛卡 果	0	0	0	0	0	0	0	0	0	0	0	0	0	0	0		批量查询
紫玛卡鲜果	0	0	0	0	0	0	0	0	0	0	0	0	0	0	0		批量查询
秘鲁紫玛卡干果	0	0	0	0	0	0	0	0	0	0	0	0	0	0	0		批量查询
新鲜紫玛卡鲜果	0	0	0	0	0	0	0	0	0	0	0	0	0	0	0		批量查询
云南紫玛卡干果	0	0	0	0	0	0	0	0	0	0	0	0	0	0	0		批量查询
丽江紫玛卡干果	0	0	0	0	0	0	0	0	0	0	0	0	0	0	0		批量查询
玛卡果 进口	0	0	0	0	0	0	0	0	0	0	0	0	0	0	0		批量查询
丽江玛卡鲜果	0	0	0	0	0	0	0	0	0	0	0	0	0	0	0		批量查询
进口玛卡干果	0	0	0	0	0	0	0	0	0	0	0	0	0	0	0		批量查询
云南玛卡厂家	0	0	0	0	0	0	0	0	0	0	0	0	0	0	0		批量查询
玛卡片泡水喝	0	0	0	0	0	0	0	0	0	0	0	0	0	0	0		批量查询
秘鲁玛卡片泡水	0	0	0	0	0	0	0	0	0	0	0	0	0	0	0		批量查询
玛卡片有什么作用	0	0	0	0	0	0	0	0	0	0	0	0	0	0	0		批量查询
干玛卡怎么吃	0	0	0	0	0	0	0	0	0	0	0	0	0	0	0		批量查询
鲜玛卡怎么吃	0	0	0	0	0	0	0	0	0	0	0	0	0	0	0		批量查询
生玛卡怎么吃	0	0	0	0	0	0	0	0	0	0	0	0	0	0	0		批量查询
玛卡玛莎连衣裙	0	0	0	0	0	0	0	0	0	0	0	0	0	0	0		批量查询
秘鲁进口玛卡果	0	0	0	0	0	0	0	0	0	0	0	0	0	0	0		批量查询
玛卡食用	0	0	0	0	0	0	0	0	0	0	0	0	0	0	0		批量查询
新鲜玛卡的食用方法	0	0	0	0	0	0	0	0	0	0	0	0	0	0	0		批量查询
新鲜玛卡一次能吃多少	0	0	0	0	0	0	0	0	0	0	0	0	0	0	0		批量查询
怎样做新鲜玛卡吃	0	0	0	0	0	0	0	0	0	0	0	0	0	0	0		批量查询
云南丽江玛卡果种子	0	0	0	0	0	0	0	0	0	0	0	0	0	0	0		批量查询
玛卡包装	0	0	0	0	0	0	0	0	0	0	0	0	0	0	0		批量查询
中药玛卡价格	0	0	0	0	0	0	0	0	0	0	0	0	0	0	0		批量查询
云南玛卡种子多少一斤	0	0	0	0	0	0	0	0	0	0	0	0	0	0	0		批量查询
玛卡种子出售	0	0	0	0	0	0	0	0	0	0	0	0	0	0	0		批量查询
云南丽江玛卡种子批发	0	0	0	0	0	0	0	0	0	0	0	0	0	0	0		批量查询
会泽玛卡种子价格	0	0	0	0	0	0	0	0	0	0	0	0	0	0	0		批量查询
玛卡种子培苗技术	0	0	0	0	0	0	0	0	0	0	0	0	0	0	0		批量查询
安第斯玛卡片 正品	0	0	0	0	0	0	0	0	0	0	0	0	0	0	0		批量查询
玛卡儿婴儿洗衣液包邮	0	0	0	0	0	0	0	0	0	0	0	0	0	0	0		批量查询
黄金玛卡胶囊 增大	0	0	0	0	0	0	0	0	0	0	0	0	0	0	0		批量查询
黄金玛卡胶囊 包邮	0	0	0	0	0	0	0	0	0	0	0	0	0	0	0		批量查询
黄金玛卡胶囊 延时	0	0	0	0	0	0	0	0	0	0	0	0	0	0	0		批量查询
黄金玛卡胶囊 补肾	0	0	0	0	0	0	0	0	0	0	0	0	0	0	0		批量查询
黄金玛卡maca胶囊	0	0	0	0	0	0	0	0	0	0	0	0	0	0	0		批量查询
正品黄金玛卡胶囊	0	0	0	0	0	0	0	0	0	0	0	0	0	0	0		批量查询
秘鲁黄金玛卡胶囊	0	0	0	0	0	0	0	0	0	0	0	0	0	0	0		批量查询
丽江玛卡果有什么作用	0	0	0	0	0	0	0	0	0	0	0	0	0	0	0		批量查询
丽江买的玛卡果怎么吃	0	0	0	0	0	0	0	0	0	0	0	0	0	0	0		批量查询
丽江玛卡真的有用吗	0	0	0	0	0	0	0	0	0	0	0	0	0	0	0		批量查询
正品玛卡益康片 补肾	0	0	0	0	0	0	0	0	0	0	0	0	0	0	0		批量查询
西藏玛卡	0	0	0	0	0	0	0	0	0	0	0	0	0	0	0		批量查询
西藏玛卡价格	0	0	0	0	0	0	0	0	0	0	0	0	0	0	0		批量查询
正品玛卡官方网站	0	0	0	0	0	0	0	0	0	0	0	0	0	0	0		批量查询
请问哪家才是正品玛卡	0	0	0	0	0	0	0	0	0	0	0	0	0	0	0		批量查询
玛卡片剂	0	0	0	0	0	0	0	0	0	0	0	0	0	0	0		批量查询
正品黄金玛卡	0	0	0	0	0	0	0	0	0	0	0	0	0	0	0		批量查询
女士 玛卡 补肾胶囊	0	0	0	0	0	0	0	0	0	0	0	0	0	0	0		批量查询
秘鲁玛卡 补肾 胶囊	0	0	0	0	0	0	0	0	0	0	0	0	0	0	0		批量查询
玛卡提取物胶囊	0	0	0	0	0	0	0	0	0	0	0	0	0	0	0		批量查询
玛卡胶囊男延时增大	0	0	0	0	0	0	0	0	0	0	0	0	0	0	0		批量查询
玛卡壮阳效果怎么样	0	0	0	0	0	0	0	0	0	0	0	0	0	0	0		批量查询
玛咖精片玛卡胶囊	0	0	0	0	0	0	0	0	0	0	0	0	0	0	0		批量查询
补肾壮阳玛卡	0	0	0	0	0	0	0	0	0	0	0	0	0	0	0		批量查询
玛卡壮阳有副作用吗	0	0	0	0	0	0	0	0	0	0	0	0	0	0	0		批量查询
玛卡果真有壮阳功效吗	0	0	0	0	0	0	0	0	0	0	0	0	0	0	0		批量查询
玛卡壮阳效果	0	0	0	0	0	0	0	0	0	0	0	0	0	0	0		批量查询
玛卡壮阳么	0	0	0	0	0	0	0	0	0	0	0	0	0	0	0		批量查询
黄金玛卡maca秘鲁玛卡胶囊	0	0	0	0	0	0	0	0	0	0	0	0	0	0	0		批量查询
美国黄金玛卡胶囊maca男用正品	0	0	0	0	0	0	0	0	0	0	0	0	0	0	0		批量查询
野口医学研究所玛卡营养胶囊	0	0	0	0	0	0	0	0	0	0	0	0	0	0	0		批量查询
浓缩玛卡胶囊	0	0	0	0	0	0	0	0	0	0	0	0	0	0	0		批量查询
玛卡补肾有效果么	0	0	0	0	0	0	0	0	0	0	0	0	0	0	0		批量查询
玛卡补肾阴阳同补吗	0	0	0	0	0	0	0	0	0	0	0	0	0	0	0		批量查询
玛卡补肾吗	0	0	0	0	0	0	0	0	0	0	0	0	0	0	0		批量查询
玛卡女人补肾有效果么	0	0	0	0	0	0	0	0	0	0	0	0	0	0	0		批量查询
补肾玛卡	0	0	0	0	0	0	0	0	0	0	0	0	0	0	0		批量查询
玛卡补肾精的食用方法	0	0	0	0	0	0	0	0	0	0	0	0	0	0	0		批量查询
玛卡可以补肾吗	0	0	0	0	0	0	0	0	0	0	0	0	0	0	0		批量查询
玛卡 补肾阴阳	0	0	0	0	0	0	0	0	0	0	0	0	0	0	0		批量查询
玛卡是补肾的吗	0	0	0	0	0	0	0	0	0	0	0	0	0	0	0		批量查询
男性保健品 玛卡 胶囊	0	0	0	0	0	0	0	0	0	0	0	0	0	0	0		批量查询
玛卡果如何服用	0	0	0	0	0	0	0	0	0	0	0	0	0	0	0		批量查询
玛卡服用后的反应	0	0	0	0	0	0	0	0	0	0	0	0	0	0	0		批量查询
服用玛卡后的感觉	0	0	0	0	0	0	0	0	0	0	0	0	0	0	0		批量查询
玛卡服用后什么症状	0	0	0	0	0	0	0	0	0	0	0	0	0	0	0		批量查询
服用玛卡后的效果图	0	0	0	0	0	0	0	0	0	0	0	0	0	0	0		批量查询
服用玛卡后	0	0	0	0	0	0	0	0	0	0	0	0	0	0	0		批量查询
服用玛卡有什么禁忌	0	0	0	0	0	0	0	0	0	0	0	0	0	0	0		批量查询
黄金玛卡1号胶囊	0	0	0	0	0	0	0	0	0	0	0	0	0	0	0		批量查询
秘鲁玛卡果 批发	0	0	0	0	0	0	0	0	0	0	0	0	0	0	0		批量查询
秘鲁玛卡果礼盒	0	0	0	0	0	0	0	0	0	0	0	0	0	0	0		批量查询
秘鲁玛卡果图片	0	0	0	0	0	0	0	0	0	0	0	0	0	0	0		批量查询
云南丽江玛卡胶囊	0	0	0	0	0	0	0	0	0	0	0	0	0	0	0		批量查询
云南鲜玛卡	0	0	0	0	0	0	0	0	0	0	0	0	0	0	0		批量查询
玛咖胶囊玛卡秘鲁正品	0	0	0	0	0	0	0	0	0	0	0	0	0	0	0		批量查询
黄玛卡和紫玛卡的区别	0	0	0	0	0	0	0	0	0	0	0	0	0	0	0		批量查询
黑玛卡 紫玛卡 黄玛卡	0	0	0	0	0	0	0	0	0	0	0	0	0	0	0		批量查询
紫玛卡 黑玛卡 那种好	0	0	0	0	0	0	0	0	0	0	0	0	0	0	0		批量查询
紫玛卡种子	0	0	0	0	0	0	0	0	0	0	0	0	0	0	0		批量查询
野生秘鲁种紫玛卡	0	0	0	0	0	0	0	0	0	0	0	0	0	0	0		批量查询
昆明紫玛卡	0	0	0	0	0	0	0	0	0	0	0	0	0	0	0		批量查询
紫颜色的玛卡干片	0	0	0	0	0	0	0	0	0	0	0	0	0	0	0		批量查询
美国时刻玛卡胶囊	0	0	0	0	0	0	0	0	0	0	0	0	0	0	0		批量查询
进口秘鲁玛卡胶囊	0	0	0	0	0	0	0	0	0	0	0	0	0	0	0		批量查询
秘鲁黑玛卡是真的吗	0	0	0	0	0	0	0	0	0	0	0	0	0	0	0		批量查询
秘鲁玛卡胶囊美国	0	0	0	0	0	0	0	0	0	0	0	0	0	0	0		批量查询
秘鲁玛卡胶囊120粒装	0	0	0	0	0	0	0	0	0	0	0	0	0	0	0		批量查询
玛卡 胶囊 秘鲁	0	0	0	0	0	0	0	0	0	0	0	0	0	0	0		批量查询
玛咖胶囊玛卡秘鲁	0	0	0	0	0	0	0	0	0	0	0	0	0	0	0		批量查询
德国秘鲁玛卡胶囊	0	0	0	0	0	0	0	0	0	0	0	0	0	0	0		批量查询
秘鲁黑玛卡胶囊	0	0	0	0	0	0	0	0	0	0	0	0	0	0	0		批量查询
maca秘鲁玛卡胶囊	0	0	0	0	0	0	0	0	0	0	0	0	0	0	0		批量查询
秘鲁玛卡 进口 胶囊	0	0	0	0	0	0	0	0	0	0	0	0	0	0	0		批量查询
玛卡果种植最低温度	0	0	0	0	0	0	0	0	0	0	0	0	0	0	0		批量查询
玛卡果 种植 武汉	0	0	0	0	0	0	0	0	0	0	0	0	0	0	0		批量查询
玛卡果人工种植	0	0	0	0	0	0	0	0	0	0	0	0	0	0	0		批量查询
玛卡适应人群	0	0	0	0	0	0	0	0	0	0	0	0	0	0	0		批量查询
玛卡含激素吗	0	0	0	0	0	0	0	0	0	0	0	0	0	0	0		批量查询
美国进口玛卡粉胶囊	0	0	0	0	0	0	0	0	0	0	0	0	0	0	0		批量查询
玛卡胶囊 美国250粒	0	0	0	0	0	0	0	0	0	0	0	0	0	0	0		批量查询
美国进口玛卡胶囊	0	0	0	0	0	0	0	0	0	0	0	0	0	0	0		批量查询
美国浓缩玛卡胶囊	0	0	0	0	0	0	0	0	0	0	0	0	0	0	0		批量查询
四川玛卡	0	0	0	0	0	0	0	0	0	0	0	0	0	0	0		批量查询
玛卡片正品	0	0	0	0	0	0	0	0	0	0	0	0	0	0	0		批量查询
浓缩玛咖玛卡胶囊	0	0	0	0	0	0	0	0	0	0	0	0	0	0	0		批量查询
益康玛卡	0	0	0	0	0	0	0	0	0	0	0	0	0	0	0		批量查询
安第斯玛卡片赠送骗局	0	0	0	0	0	0	0	0	0	0	0	0	0	0	0		批量查询
玛卡益康片官方正品	0	0	0	0	0	0	0	0	0	0	0	0	0	0	0		批量查询
黄金玛卡胶囊好用吗	0	0	0	0	0	0	0	0	0	0	0	0	0	0	0		批量查询
正品益康玛卡条形码	0	0	0	0	0	0	0	0	0	0	0	0	0	0	0		批量查询
玛卡益康片官网是哪个	0	0	0	0	0	0	0	0	0	0	0	0	0	0	0		批量查询
玛卡益康片 秘鲁正品	0	0	0	0	0	0	0	0	0	0	0	0	0	0	0		批量查询
增大延时药玛卡	0	0	0	0	0	0	0	0	0	0	0	0	0	0	0		批量查询
玛卡有延时作用吗	0	0	0	0	0	0	0	0	0	0	0	0	0	0	0		批量查询
秘鲁进口速效玛卡胶囊	0	0	0	0	0	0	0	0	0	0	0	0	0	0	0		批量查询
袐鲁进口速效玛卡胶囊	0	0	0	0	0	0	0	0	0	0	0	0	0	0	0		批量查询
玛卡益康 秘鲁	0	0	0	0	0	0	0	0	0	0	0	0	0	0	0		批量查询
拉摩力拉牌玛卡片效果如何	0	0	0	0	0	0	0	0	0	0	0	0	0	0	0		批量查询
日本玛卡	0	0	0	0	0	0	0	0	0	0	0	0	0	0	0		批量查询
日本玛卡的功效	0	0	0	0	0	0	0	0	0	0	0	0	0	0	0		批量查询
日本野口玛卡	0	0	0	0	0	0	0	0	0	0	0	0	0	0	0		批量查询
日本有玛卡吗	0	0	0	0	0	0	0	0	0	0	0	0	0	0	0		批量查询
玛卡片 精品盒装	0	0	0	0	0	0	0	0	0	0	0	0	0	0	0		批量查询
秘鲁玛卡吃多少有效果	0	0	0	0	0	0	0	0	0	0	0	0	0	0	0		批量查询
秘鲁玛卡女人吃可以么	0	0	0	0	0	0	0	0	0	0	0	0	0	0	0		批量查询
秘鲁玛卡女性可以吃吗	0	0	0	0	0	0	0	0	0	0	0	0	0	0	0		批量查询
秘鲁玛卡吃的会上火吗	0	0	0	0	0	0	0	0	0	0	0	0	0	0	0		批量查询
秘鲁玛卡吃多久见效	0	0	0	0	0	0	0	0	0	0	0	0	0	0	0		批量查询
秘鲁玛卡女性能吃吗	0	0	0	0	0	0	0	0	0	0	0	0	0	0	0		批量查询
玛卡 maca	0	0	0	0	0	0	0	0	0	0	0	0	0	0	0		批量查询
玛卡片 oem	0	0	0	0	0	0	0	0	0	0	0	0	0	0	0		批量查询
玛卡植物图片	0	0	0	0	0	0	0	0	0	0	0	0	0	0	0		批量查询
新鲜玛卡图片	0	0	0	0	0	0	0	0	0	0	0	0	0	0	0		批量查询
玛卡益康咀嚼	0	0	0	0	0	0	0	0	0	0	0	0	0	0	0		批量查询
干玛卡果如何食用	0	0	0	0	0	0	0	0	0	0	0	0	0	0	0		批量查询
玛卡益康right	0	0	0	0	0	0	0	0	0	0	0	0	0	0	0		批量查询
玛卡晒干片的食用方法	0	0	0	0	0	0	0	0	0	0	0	0	0	0	0		批量查询
天然玛卡的食用方法	0	0	0	0	0	0	0	0	0	0	0	0	0	0	0		批量查询
玛卡果怎么吃效果好	0	0	0	0	0	0	0	0	0	0	0	0	0	0	0		批量查询
正品第三代玛卡益康	0	0	0	0	0	0	0	0	0	0	0	0	0	0	0		批量查询
秘鲁玛卡干果500克	0	0	0	0	0	0	0	0	0	0	0	0	0	0	0		批量查询
秘鲁玛卡干果500	0	0	0	0	0	0	0	0	0	0	0	0	0	0	0		批量查询
秘鲁玛卡干果代购	0	0	0	0	0	0	0	0	0	0	0	0	0	0	0		批量查询
秘鲁玛卡干果批发	0	0	0	0	0	0	0	0	0	0	0	0	0	0	0		批量查询
秘鲁玛卡干果 补肾	0	0	0	0	0	0	0	0	0	0	0	0	0	0	0		批量查询
秘鲁玛卡干果250克	0	0	0	0	0	0	0	0	0	0	0	0	0	0	0		批量查询
秘鲁玛卡干果 保健品	0	0	0	0	0	0	0	0	0	0	0	0	0	0	0		批量查询
秘鲁玛卡干果100克	0	0	0	0	0	0	0	0	0	0	0	0	0	0	0		批量查询
秘鲁玛卡干果干片粉	0	0	0	0	0	0	0	0	0	0	0	0	0	0	0		批量查询
玛卡干果批发价格	0	0	0	0	0	0	0	0	0	0	0	0	0	0	0		批量查询
玛卡果收购价格	0	0	0	0	0	0	0	0	0	0	0	0	0	0	0		批量查询
玛卡益康r	0	0	0	0	0	0	0	0	0	0	0	0	0	0	0		批量查询
秘鲁玛卡胶囊是真的吗	0	0	0	0	0	0	0	0	0	0	0	0	0	0	0		批量查询
有谁吃过秘鲁玛卡胶囊	0	0	0	0	0	0	0	0	0	0	0	0	0	0	0		批量查询
秘鲁玛卡胶囊多少钱	0	0	0	0	0	0	0	0	0	0	0	0	0	0	0		批量查询
秘鲁玛卡胶囊效果如何	0	0	0	0	0	0	0	0	0	0	0	0	0	0	0		批量查询
玛咖肾胶囊玛卡秘鲁	0	0	0	0	0	0	0	0	0	0	0	0	0	0	0		批量查询
秘鲁黄玛卡干果	0	0	0	0	0	0	0	0	0	0	0	0	0	0	0		批量查询
秘鲁玛卡 进口 保健品	0	0	0	0	0	0	0	0	0	0	0	0	0	0	0		批量查询
秘鲁玛卡 进口 成人	0	0	0	0	0	0	0	0	0	0	0	0	0	0	0		批量查询
秘鲁玛卡 进口 拉牌	0	0	0	0	0	0	0	0	0	0	0	0	0	0	0		批量查询
秘鲁玛卡 进口 120粒	0	0	0	0	0	0	0	0	0	0	0	0	0	0	0		批量查询
秘鲁进口黑玛卡干果	0	0	0	0	0	0	0	0	0	0	0	0	0	0	0		批量查询
美国玛卡胶囊怎么样	0	0	0	0	0	0	0	0	0	0	0	0	0	0	0		批量查询
南京美国时刻玛卡胶囊	0	0	0	0	0	0	0	0	0	0	0	0	0	0	0		批量查询
秘鲁玛卡种子包邮	0	0	0	0	0	0	0	0	0	0	0	0	0	0	0		批量查询
正品秘鲁玛卡种子	0	0	0	0	0	0	0	0	0	0	0	0	0	0	0		批量查询
秘鲁黑玛卡种子	0	0	0	0	0	0	0	0	0	0	0	0	0	0	0		批量查询
轩庆 玛卡 玛咖精片	0	0	0	0	0	0	0	0	0	0	0	0	0	0	0		批量查询
云南奥咖玛卡精片官网	0	0	0	0	0	0	0	0	0	0	0	0	0	0	0		批量查询
广州七福玛玛卡精片	0	0	0	0	0	0	0	0	0	0	0	0	0	0	0		批量查询
7福玛玛卡精片	0	0	0	0	0	0	0	0	0	0	0	0	0	0	0		批量查询
玛咖和玛卡有什么区别	0	0	0	0	0	0	0	0	0	0	0	0	0	0	0		批量查询
玛卡与玛咖的区别	0	0	0	0	0	0	0	0	0	0	0	0	0	0	0		批量查询
秘鲁玛卡精片干片	0	0	0	0	0	0	0	0	0	0	0	0	0	0	0		批量查询
秘鲁玛卡精片补肾	0	0	0	0	0	0	0	0	0	0	0	0	0	0	0		批量查询
秘鲁进口玛卡精片	0	0	0	0	0	0	0	0	0	0	0	0	0	0	0		批量查询
秘鲁玛咖 玛卡精片	0	0	0	0	0	0	0	0	0	0	0	0	0	0	0		批量查询
云南玛卡精片 秘鲁	0	0	0	0	0	0	0	0	0	0	0	0	0	0	0		批量查询
原装秘鲁黑玛卡精片	0	0	0	0	0	0	0	0	0	0	0	0	0	0	0		批量查询
班寨秘鲁玛卡精片	0	0	0	0	0	0	0	0	0	0	0	0	0	0	0		批量查询
秘鲁玛卡粉 进口 黑	0	0	0	0	0	0	0	0	0	0	0	0	0	0	0		批量查询
秘鲁糊化玛卡粉	0	0	0	0	0	0	0	0	0	0	0	0	0	0	0		批量查询
丽江正品秘鲁玛卡粉	0	0	0	0	0	0	0	0	0	0	0	0	0	0	0		批量查询
秘鲁 黑玛卡粉 代购	0	0	0	0	0	0	0	0	0	0	0	0	0	0	0		批量查询
进口秘鲁玛卡粉	0	0	0	0	0	0	0	0	0	0	0	0	0	0	0		批量查询
正宗秘鲁玛卡粉	0	0	0	0	0	0	0	0	0	0	0	0	0	0	0		批量查询
原装秘鲁玛卡粉	0	0	0	0	0	0	0	0	0	0	0	0	0	0	0		批量查询
玛卡胶囊是正规药吗	0	0	0	0	0	0	0	0	0	0	0	0	0	0	0		批量查询
台湾享硬玛卡浓缩片	0	0	0	0	0	0	0	0	0	0	0	0	0	0	0		批量查询
享硬玛卡浓缩片 勃增	0	0	0	0	0	0	0	0	0	0	0	0	0	0	0		批量查询
四川电视台上玛卡胶囊	0	0	0	0	0	0	0	0	0	0	0	0	0	0	0		批量查询
玛卡浓缩片v9	0	0	0	0	0	0	0	0	0	0	0	0	0	0	0		批量查询
爱司盟浓缩玛卡	0	0	0	0	0	0	0	0	0	0	0	0	0	0	0		批量查询
浓缩玛卡	0	0	0	0	0	0	0	0	0	0	0	0	0	0	0		批量查询
健体享硬玛卡浓缩片	0	0	0	0	0	0	0	0	0	0	0	0	0	0	0		批量查询
进口秘鲁玛卡 中药	0	0	0	0	0	0	0	0	0	0	0	0	0	0	0		批量查询
秘鲁玛卡 进口玛卡	0	0	0	0	0	0	0	0	0	0	0	0	0	0	0		批量查询
美国黄金玛卡胶囊	0	0	0	0	0	0	0	0	0	0	0	0	0	0	0		批量查询
美国时刻玛卡	0	0	0	0	0	0	0	0	0	0	0	0	0	0	0		批量查询
中药玛卡 秘鲁玛卡	0	0	0	0	0	0	0	0	0	0	0	0	0	0	0		批量查询
中药材玛卡秘鲁正品	0	0	0	0	0	0	0	0	0	0	0	0	0	0	0		批量查询
中药材玛卡秘鲁	0	0	0	0	0	0	0	0	0	0	0	0	0	0	0		批量查询
秘鲁玛卡 60片	0	0	0	0	0	0	0	0	0	0	0	0	0	0	0		批量查询
秘鲁玛卡60片 正品	0	0	0	0	0	0	0	0	0	0	0	0	0	0	0		批量查询
秘鲁玛卡正品保健品	0	0	0	0	0	0	0	0	0	0	0	0	0	0	0		批量查询
秘鲁玛卡正品30片	0	0	0	0	0	0	0	0	0	0	0	0	0	0	0		批量查询
玛卡 秘鲁 正品 补肾	0	0	0	0	0	0	0	0	0	0	0	0	0	0	0		批量查询
玛卡益康真的有用吗	0	0	0	0	0	0	0	0	0	0	0	0	0	0	0		批量查询
秘鲁玛卡果干片	0	0	0	0	0	0	0	0	0	0	0	0	0	0	0		批量查询
男人保健品 玛卡秘鲁	0	0	0	0	0	0	0	0	0	0	0	0	0	0	0		批量查询
秘鲁玛卡 性保健品	0	0	0	0	0	0	0	0	0	0	0	0	0	0	0		批量查询
玛卡秘鲁 保健品	0	0	0	0	0	0	0	0	0	0	0	0	0	0	0		批量查询
秘鲁玛卡男性保健品	0	0	0	0	0	0	0	0	0	0	0	0	0	0	0		批量查询
原装玛卡	0	0	0	0	0	0	0	0	0	0	0	0	0	0	0		批量查询
秘鲁玛卡maca补肾	0	0	0	0	0	0	0	0	0	0	0	0	0	0	0		批量查询
秘鲁玛卡 60粒	0	0	0	0	0	0	0	0	0	0	0	0	0	0	0		批量查询
倍斯万玛卡益康片官网	0	0	0	0	0	0	0	0	0	0	0	0	0	0	0		批量查询
倍斯万玛卡益康片 骗	0	0	0	0	0	0	0	0	0	0	0	0	0	0	0		批量查询
玛卡倍斯万	0	0	0	0	0	0	0	0	0	0	0	0	0	0	0		批量查询
玛卡胶囊价格	0	0	0	0	0	0	0	0	0	0	0	0	0	0	0		批量查询
玛卡倍斯万真假识别	0	0	0	0	0	0	0	0	0	0	0	0	0	0	0		批量查询
倍斯万玛卡中国官网	0	0	0	0	0	0	0	0	0	0	0	0	0	0	0		批量查询
玛卡倍斯万价格	0	0	0	0	0	0	0	0	0	0	0	0	0	0	0		批量查询
玛卡倍斯万是否真药	0	0	0	0	0	0	0	0	0	0	0	0	0	0	0		批量查询
玛卡倍斯万几天见效	0	0	0	0	0	0	0	0	0	0	0	0	0	0	0		批量查询
秘鲁玛卡 进口玛卡 maca干果	0	0	0	0	0	0	0	0	0	0	0	0	0	0	0		批量查询
摩力拉maca秘鲁玛卡	0	0	0	0	0	0	0	0	0	0	0	0	0	0	0		批量查询
拉摩力拉maca秘鲁玛卡	0	0	0	0	0	0	0	0	0	0	0	0	0	0	0		批量查询
蛮哥玛卡 秘鲁maca	0	0	0	0	0	0	0	0	0	0	0	0	0	0	0		批量查询
乐维士玛卡胶囊	0	0	0	0	0	0	0	0	0	0	0	0	0	0	0		批量查询
玛卡精片 补肾 男人	0	0	0	0	0	0	0	0	0	0	0	0	0	0	0		批量查询
玛卡精片 补肾 男性	0	0	0	0	0	0	0	0	0	0	0	0	0	0	0		批量查询
玛卡精片 补肾保健品	0	0	0	0	0	0	0	0	0	0	0	0	0	0	0		批量查询
玛卡精片 补肾 丽江	0	0	0	0	0	0	0	0	0	0	0	0	0	0	0		批量查询
玛卡精片 补肾 增大	0	0	0	0	0	0	0	0	0	0	0	0	0	0	0		批量查询
云南玛卡精片 补肾	0	0	0	0	0	0	0	0	0	0	0	0	0	0	0		批量查询
玛卡精片补肾健体	0	0	0	0	0	0	0	0	0	0	0	0	0	0	0		批量查询
高原玛卡精片补肾	0	0	0	0	0	0	0	0	0	0	0	0	0	0	0		批量查询
丽江紫玛卡精片 补肾	0	0	0	0	0	0	0	0	0	0	0	0	0	0	0		批量查询
丽江玛卡精片简装	0	0	0	0	0	0	0	0	0	0	0	0	0	0	0		批量查询
玛卡精片男人保健	0	0	0	0	0	0	0	0	0	0	0	0	0	0	0		批量查询
美国黄金玛卡maca15粒	0	0	0	0	0	0	0	0	0	0	0	0	0	0	0		批量查询
玛卡益康片货到付款	0	0	0	0	0	0	0	0	0	0	0	0	0	0	0		批量查询
美国黄金玛卡的副作用	0	0	0	0	0	0	0	0	0	0	0	0	0	0	0		批量查询
延时增大玛卡精片	0	0	0	0	0	0	0	0	0	0	0	0	0	0	0		批量查询
秘鲁玛卡之家	0	0	0	0	0	0	0	0	0	0	0	0	0	0	0		批量查询
玛卡益康片 延时	0	0	0	0	0	0	0	0	0	0	0	0	0	0	0		批量查询
乐维士玛卡	0	0	0	0	0	0	0	0	0	0	0	0	0	0	0		批量查询
诺天源乐维士玛卡	0	0	0	0	0	0	0	0	0	0	0	0	0	0	0		批量查询
货到付款玛卡胶囊	0	0	0	0	0	0	0	0	0	0	0	0	0	0	0		批量查询
玛卡益康片 进口	0	0	0	0	0	0	0	0	0	0	0	0	0	0	0		批量查询
云南玛卡精片 保健品	0	0	0	0	0	0	0	0	0	0	0	0	0	0	0		批量查询
玛卡精片 男士保健品	0	0	0	0	0	0	0	0	0	0	0	0	0	0	0		批量查询
云南丽江玛卡粉	0	0	0	0	0	0	0	0	0	0	0	0	0	0	0		批量查询
正品云南玛卡粉	0	0	0	0	0	0	0	0	0	0	0	0	0	0	0		批量查询
云南丽江黑玛卡粉	0	0	0	0	0	0	0	0	0	0	0	0	0	0	0		批量查询
云南丽江玛咖粉 玛卡	0	0	0	0	0	0	0	0	0	0	0	0	0	0	0		批量查询
云南纯天然玛卡粉	0	0	0	0	0	0	0	0	0	0	0	0	0	0	0		批量查询
云南紫玛卡精粉	0	0	0	0	0	0	0	0	0	0	0	0	0	0	0		批量查询
玛卡果的颜色 主要作用	0	0	0	0	0	0	0	0	0	0	0	0	0	0	0		批量查询
正品玛卡干果干片粉	0	0	0	0	0	0	0	0	0	0	0	0	0	0	0		批量查询
如何出口秘鲁玛卡干果	0	0	0	0	0	0	0	0	0	0	0	0	0	0	0		批量查询
秘鲁玛卡干果大量代购	0	0	0	0	0	0	0	0	0	0	0	0	0	0	0		批量查询
秘鲁玛卡干果多少钱	0	0	0	0	0	0	0	0	0	0	0	0	0	0	0		批量查询
秘鲁纯进口 玛卡干果	0	0	0	0	0	0	0	0	0	0	0	0	0	0	0		批量查询
进口maca玛卡粉胶囊	0	0	0	0	0	0	0	0	0	0	0	0	0	0	0		批量查询
玛卡益康片是不是真药	0	0	0	0	0	0	0	0	0	0	0	0	0	0	0		批量查询
玛卡益康片真的管用吗	0	0	0	0	0	0	0	0	0	0	0	0	0	0	0		批量查询
玛卡益康片 补肾	0	0	0	0	0	0	0	0	0	0	0	0	0	0	0		批量查询
玛卡益康效果	0	0	0	0	0	0	0	0	0	0	0	0	0	0	0		批量查询
玛卡益康效果怎么样	0	0	0	0	0	0	0	0	0	0	0	0	0	0	0		批量查询
如何进口秘鲁玛卡清关	0	0	0	0	0	0	0	0	0	0	0	0	0	0	0		批量查询
秘鲁玛卡代理进口	0	0	0	0	0	0	0	0	0	0	0	0	0	0	0		批量查询
秘鲁玛卡进口清关	0	0	0	0	0	0	0	0	0	0	0	0	0	0	0		批量查询
玛卡正品 精片	0	0	0	0	0	0	0	0	0	0	0	0	0	0	0		批量查询
正品云南紫玛卡精片	0	0	0	0	0	0	0	0	0	0	0	0	0	0	0		批量查询
正品玛咖玛卡精片	0	0	0	0	0	0	0	0	0	0	0	0	0	0	0		批量查询
正品黑玛卡精片	0	0	0	0	0	0	0	0	0	0	0	0	0	0	0		批量查询
玛卡益康片 玛咖	0	0	0	0	0	0	0	0	0	0	0	0	0	0	0		批量查询
云南玛卡精片 女用	0	0	0	0	0	0	0	0	0	0	0	0	0	0	0		批量查询
云南玛卡益康精片	0	0	0	0	0	0	0	0	0	0	0	0	0	0	0		批量查询
云南丽江玛卡精片	0	0	0	0	0	0	0	0	0	0	0	0	0	0	0		批量查询
云南黑玛卡精片	0	0	0	0	0	0	0	0	0	0	0	0	0	0	0		批量查询
云南玛卡玛咖精片	0	0	0	0	0	0	0	0	0	0	0	0	0	0	0		批量查询
云南天然玛卡精片	0	0	0	0	0	0	0	0	0	0	0	0	0	0	0		批量查询
丽江玛卡玛咖精片	0	0	0	0	0	0	0	0	0	0	0	0	0	0	0		批量查询
迈卡牌玛卡精片 丽江	0	0	0	0	0	0	0	0	0	0	0	0	0	0	0		批量查询
云南丽江黑玛卡精片	0	0	0	0	0	0	0	0	0	0	0	0	0	0	0		批量查询
丽江力玛卡精片	0	0	0	0	0	0	0	0	0	0	0	0	0	0	0		批量查询
益诺玛卡精片正品	0	0	0	0	0	0	0	0	0	0	0	0	0	0	0		批量查询
正品玛卡咖精片	0	0	0	0	0	0	0	0	0	0	0	0	0	0	0		批量查询
秘鲁玛卡粉怎么服用	0	0	0	0	0	0	0	0	0	0	0	0	0	0	0		批量查询
玛卡玛咖精片	0	0	0	0	0	0	0	0	0	0	0	0	0	0	0		批量查询
巨青玛卡玛咖精片	0	0	0	0	0	0	0	0	0	0	0	0	0	0	0		批量查询
古之极玛咖精片玛卡	0	0	0	0	0	0	0	0	0	0	0	0	0	0	0		批量查询
玛卡玛咖精片艾克	0	0	0	0	0	0	0	0	0	0	0	0	0	0	0		批量查询
黑玛卡精片玛咖精片	0	0	0	0	0	0	0	0	0	0	0	0	0	0	0		批量查询
云南丽江玛卡 玛咖精片	0	0	0	0	0	0	0	0	0	0	0	0	0	0	0		批量查询
巨青玛卡	0	0	0	0	0	0	0	0	0	0	0	0	0	0	0		批量查询
七福玛玛卡精?搜搜	0	0	0	0	0	0	0	0	0	0	0	0	0	0	0		批量查询
云南玛卡泡酒	0	0	0	0	0	0	0	0	0	0	0	0	0	0	0		批量查询
maca玛卡对女性的功效	0	0	0	0	0	0	0	0	0	0	0	0	0	0	0		批量查询
maca玛卡吃几天有效果	0	0	0	0	0	0	0	0	0	0	0	0	0	0	0		批量查询
maca玛卡饮品加工	0	0	0	0	0	0	0	0	0	0	0	0	0	0	0		批量查询
女性能吃玛卡maca	0	0	0	0	0	0	0	0	0	0	0	0	0	0	0		批量查询
玛卡益康片正品	0	0	0	0	0	0	0	0	0	0	0	0	0	0	0		批量查询
黑玛卡片	0	0	0	0	0	0	0	0	0	0	0	0	0	0	0		批量查询
黑玛卡干果	0	0	0	0	0	0	0	0	0	0	0	0	0	0	0		批量查询
黑玛卡 货到付款	0	0	0	0	0	0	0	0	0	0	0	0	0	0	0		批量查询
黑玛卡片 日本原装进口	0	0	0	0	0	0	0	0	0	0	0	0	0	0	0		批量查询
云南丽江玛卡价格	0	0	0	0	0	0	0	0	0	0	0	0	0	0	0		批量查询
云南药材玛卡价格	0	0	0	0	0	0	0	0	0	0	0	0	0	0	0		批量查询
云南玛卡的收购价格	0	0	0	0	0	0	0	0	0	0	0	0	0	0	0		批量查询
云南玛卡种子价格	0	0	0	0	0	0	0	0	0	0	0	0	0	0	0		批量查询
云南新鲜玛卡价格	0	0	0	0	0	0	0	0	0	0	0	0	0	0	0		批量查询
云南丽江野生玛卡价格	0	0	0	0	0	0	0	0	0	0	0	0	0	0	0		批量查询
云南产玛卡价格	0	0	0	0	0	0	0	0	0	0	0	0	0	0	0		批量查询
天然玛卡有效果吗	0	0	0	0	0	0	0	0	0	0	0	0	0	0	0		批量查询
益康玛卡片	0	0	0	0	0	0	0	0	0	0	0	0	0	0	0		批量查询
秘鲁原装 玛卡	0	0	0	0	0	0	0	0	0	0	0	0	0	0	0		批量查询
秘鲁玛卡 原装	0	0	0	0	0	0	0	0	0	0	0	0	0	0	0		批量查询
郑州药店买玛卡益康片	0	0	0	0	0	0	0	0	0	0	0	0	0	0	0		批量查询
原装秘鲁 玛卡好药师健康馆	0	0	0	0	0	0	0	0	0	0	0	0	0	0	0		批量查询
玛卡益康片女人吃	0	0	0	0	0	0	0	0	0	0	0	0	0	0	0		批量查询
玛卡益康片 吃后感觉	0	0	0	0	0	0	0	0	0	0	0	0	0	0	0		批量查询
玛卡益康咀嚼片怎么吃	0	0	0	0	0	0	0	0	0	0	0	0	0	0	0		批量查询
进口玛卡粉	0	0	0	0	0	0	0	0	0	0	0	0	0	0	0		批量查询
进口玛卡粉250	0	0	0	0	0	0	0	0	0	0	0	0	0	0	0		批量查询
服用玛卡	0	0	0	0	0	0	0	0	0	0	0	0	0	0	0		批量查询
玛卡片加工	0	0	0	0	0	0	0	0	0	0	0	0	0	0	0		批量查询
赫名堂玛卡微精片	0	0	0	0	0	0	0	0	0	0	0	0	0	0	0		批量查询
玛卡粉的用量	0	0	0	0	0	0	0	0	0	0	0	0	0	0	0		批量查询
玛咖干果 丽江玛卡粉	0	0	0	0	0	0	0	0	0	0	0	0	0	0	0		批量查询
玛卡精粉 丽江	0	0	0	0	0	0	0	0	0	0	0	0	0	0	0		批量查询
丽江高原玛卡粉	0	0	0	0	0	0	0	0	0	0	0	0	0	0	0		批量查询
丽江玛卡 玛咖粉	0	0	0	0	0	0	0	0	0	0	0	0	0	0	0		批量查询
玛卡粉片加工	0	0	0	0	0	0	0	0	0	0	0	0	0	0	0		批量查询
玛卡果的功效与作用	0	0	0	0	0	0	0	0	0	0	0	0	0	0	0		批量查询
玛卡果怎么吃 图	0	0	0	0	0	0	0	0	0	0	0	0	0	0	0		批量查询
玛卡果如何吃	0	0	0	0	0	0	0	0	0	0	0	0	0	0	0		批量查询
玛卡果干怎么吃	0	0	0	0	0	0	0	0	0	0	0	0	0	0	0		批量查询
玛卡果泡什么茶吃	0	0	0	0	0	0	0	0	0	0	0	0	0	0	0		批量查询
怎样吃玛卡果	0	0	0	0	0	0	0	0	0	0	0	0	0	0	0		批量查询
玛卡原果怎么吃	0	0	0	0	0	0	0	0	0	0	0	0	0	0	0		批量查询
干玛卡果 功效	0	0	0	0	0	0	0	0	0	0	0	0	0	0	0		批量查询
云南玛卡粉如何吃	0	0	0	0	0	0	0	0	0	0	0	0	0	0	0		批量查询
云南玛卡粉吃法	0	0	0	0	0	0	0	0	0	0	0	0	0	0	0		批量查询
云南丽江生产的玛卡粉	0	0	0	0	0	0	0	0	0	0	0	0	0	0	0		批量查询
云南玛卡干果500克	0	0	0	0	0	0	0	0	0	0	0	0	0	0	0		批量查询
紫玛卡干果500克	0	0	0	0	0	0	0	0	0	0	0	0	0	0	0		批量查询
云南紫玛卡干果500克	0	0	0	0	0	0	0	0	0	0	0	0	0	0	0		批量查询
黑玛卡干果500克	0	0	0	0	0	0	0	0	0	0	0	0	0	0	0		批量查询
丽江黑玛卡干果500克	0	0	0	0	0	0	0	0	0	0	0	0	0	0	0		批量查询
丽江紫玛卡干果500克	0	0	0	0	0	0	0	0	0	0	0	0	0	0	0		批量查询
丽江黄玛卡干果500克	0	0	0	0	0	0	0	0	0	0	0	0	0	0	0		批量查询
黄玛卡干果500克	0	0	0	0	0	0	0	0	0	0	0	0	0	0	0		批量查询
丽江紫玛卡干果批发	0	0	0	0	0	0	0	0	0	0	0	0	0	0	0		批量查询
秘鲁黑玛卡干果批发	0	0	0	0	0	0	0	0	0	0	0	0	0	0	0		批量查询
黑玛卡干果批发	0	0	0	0	0	0	0	0	0	0	0	0	0	0	0		批量查询
秘鲁黄玛卡干果批发	0	0	0	0	0	0	0	0	0	0	0	0	0	0	0		批量查询
玛卡干果干片批发	0	0	0	0	0	0	0	0	0	0	0	0	0	0	0		批量查询
紫玛卡干果批发	0	0	0	0	0	0	0	0	0	0	0	0	0	0	0		批量查询
进口玛卡粉那里有卖	0	0	0	0	0	0	0	0	0	0	0	0	0	0	0		批量查询
玛卡巴卡	0	0	0	0	0	0	0	0	0	0	0	0	0	0	0		批量查询
进口玛卡什么牌子好	0	0	0	0	0	0	0	0	0	0	0	0	0	0	0		批量查询
国内玛卡和进口的区别	0	0	0	0	0	0	0	0	0	0	0	0	0	0	0		批量查询
进口玛卡管用吗	0	0	0	0	0	0	0	0	0	0	0	0	0	0	0		批量查询
玛卡怎么辨别进口的	0	0	0	0	0	0	0	0	0	0	0	0	0	0	0		批量查询
玛卡干果片	0	0	0	0	0	0	0	0	0	0	0	0	0	0	0		批量查询
玛卡云南元素	0	0	0	0	0	0	0	0	0	0	0	0	0	0	0		批量查询
玛咖片 玛卡	0	0	0	0	0	0	0	0	0	0	0	0	0	0	0		批量查询
诺奥玛卡	0	0	0	0	0	0	0	0	0	0	0	0	0	0	0		批量查询
玛卡粉一次吃多少克	0	0	0	0	0	0	0	0	0	0	0	0	0	0	0		批量查询
玛卡粉多少钱一克	0	0	0	0	0	0	0	0	0	0	0	0	0	0	0		批量查询
玛卡500mg和玛卡750mg	0	0	0	0	0	0	0	0	0	0	0	0	0	0	0		批量查询
玛卡胶囊 500mg	0	0	0	0	0	0	0	0	0	0	0	0	0	0	0		批量查询
玛卡胶囊 500mg 服用	0	0	0	0	0	0	0	0	0	0	0	0	0	0	0		批量查询
玛卡胶囊500mg怎么吃	0	0	0	0	0	0	0	0	0	0	0	0	0	0	0		批量查询
丽江玛卡干果 补肾	0	0	0	0	0	0	0	0	0	0	0	0	0	0	0		批量查询
丽江产玛卡粉胶囊	0	0	0	0	0	0	0	0	0	0	0	0	0	0	0		批量查询
玛卡干果特价黑色	0	0	0	0	0	0	0	0	0	0	0	0	0	0	0		批量查询
黑玛卡干果 特价折扣	0	0	0	0	0	0	0	0	0	0	0	0	0	0	0		批量查询
紫玛卡干果特价	0	0	0	0	0	0	0	0	0	0	0	0	0	0	0		批量查询
玛咖 玛卡 粉怎么吃	0	0	0	0	0	0	0	0	0	0	0	0	0	0	0		批量查询
玛卡和玛咖什么区别	0	0	0	0	0	0	0	0	0	0	0	0	0	0	0		批量查询
玛卡和玛咖是一种药吗	0	0	0	0	0	0	0	0	0	0	0	0	0	0	0		批量查询
秘鲁玛卡 进口	0	0	0	0	0	0	0	0	0	0	0	0	0	0	0		批量查询
原产地批发玛卡干果	0	0	0	0	0	0	0	0	0	0	0	0	0	0	0		批量查询
玛卡根粉末	0	0	0	0	0	0	0	0	0	0	0	0	0	0	0		批量查询
玛卡的粉末的功效	0	0	0	0	0	0	0	0	0	0	0	0	0	0	0		批量查询
丽江 玛卡 oem	0	0	0	0	0	0	0	0	0	0	0	0	0	0	0		批量查询
云南古之极玛卡精片	0	0	0	0	0	0	0	0	0	0	0	0	0	0	0		批量查询
云南文山玛卡精片	0	0	0	0	0	0	0	0	0	0	0	0	0	0	0		批量查询
秘鲁玛卡胶囊正品	0	0	0	0	0	0	0	0	0	0	0	0	0	0	0		批量查询
秘鲁玛卡效果是真是假	0	0	0	0	0	0	0	0	0	0	0	0	0	0	0		批量查询
玛卡片玛咖	0	0	0	0	0	0	0	0	0	0	0	0	0	0	0		批量查询
秘鲁玛卡效果好吗	0	0	0	0	0	0	0	0	0	0	0	0	0	0	0		批量查询
秘鲁玛卡真的增大吗	0	0	0	0	0	0	0	0	0	0	0	0	0	0	0		批量查询
到哪能买到真秘鲁玛卡	0	0	0	0	0	0	0	0	0	0	0	0	0	0	0		批量查询
秘鲁玛卡那里有真货	0	0	0	0	0	0	0	0	0	0	0	0	0	0	0		批量查询
玛卡片maca	0	0	0	0	0	0	0	0	0	0	0	0	0	0	0		批量查询
最真的秘鲁玛卡产品	0	0	0	0	0	0	0	0	0	0	0	0	0	0	0		批量查询
哪买真的秘鲁玛卡	0	0	0	0	0	0	0	0	0	0	0	0	0	0	0		批量查询
秘鲁天然玛卡是真的吗	0	0	0	0	0	0	0	0	0	0	0	0	0	0	0		批量查询
孕妇可以吃玛卡吗	0	0	0	0	0	0	0	0	0	0	0	0	0	0	0		批量查询
吃玛卡的禁忌	0	0	0	0	0	0	0	0	0	0	0	0	0	0	0		批量查询
拉秘鲁玛卡的网站	0	0	0	0	0	0	0	0	0	0	0	0	0	0	0		批量查询
秘鲁天然玛卡官方网站	0	0	0	0	0	0	0	0	0	0	0	0	0	0	0		批量查询
玛卡干片500克包邮	0	0	0	0	0	0	0	0	0	0	0	0	0	0	0		批量查询
玛卡干片500克补肾	0	0	0	0	0	0	0	0	0	0	0	0	0	0	0		批量查询
黑玛卡干片500克	0	0	0	0	0	0	0	0	0	0	0	0	0	0	0		批量查询
紫玛卡干片500克	0	0	0	0	0	0	0	0	0	0	0	0	0	0	0		批量查询
丽江玛卡干片 500克	0	0	0	0	0	0	0	0	0	0	0	0	0	0	0		批量查询
云南玛卡干片500克	0	0	0	0	0	0	0	0	0	0	0	0	0	0	0		批量查询
紫玛卡干片500克补肾	0	0	0	0	0	0	0	0	0	0	0	0	0	0	0		批量查询
黄玛卡干片500克	0	0	0	0	0	0	0	0	0	0	0	0	0	0	0		批量查询
秘鲁玛卡的副作用	0	0	0	0	0	0	0	0	0	0	0	0	0	0	0		批量查询
长期服用玛卡的副作用	0	0	0	0	0	0	0	0	0	0	0	0	0	0	0		批量查询
服用玛卡有什么副作用	0	0	0	0	0	0	0	0	0	0	0	0	0	0	0		批量查询
玛卡干片500包邮	0	0	0	0	0	0	0	0	0	0	0	0	0	0	0		批量查询
玛卡干片500g包邮	0	0	0	0	0	0	0	0	0	0	0	0	0	0	0		批量查询
丽江玛卡干果干片	0	0	0	0	0	0	0	0	0	0	0	0	0	0	0		批量查询
紫玛卡干片 干果	0	0	0	0	0	0	0	0	0	0	0	0	0	0	0		批量查询
中药玛卡干片干果	0	0	0	0	0	0	0	0	0	0	0	0	0	0	0		批量查询
云南黑玛卡干果干片	0	0	0	0	0	0	0	0	0	0	0	0	0	0	0		批量查询
黑玛卡干果干片	0	0	0	0	0	0	0	0	0	0	0	0	0	0	0		批量查询
云南玛卡干果干片	0	0	0	0	0	0	0	0	0	0	0	0	0	0	0		批量查询
玛卡片 正品	0	0	0	0	0	0	0	0	0	0	0	0	0	0	0		批量查询
玛卡干果吃法	0	0	0	0	0	0	0	0	0	0	0	0	0	0	0		批量查询
秘鲁玛卡使用方法	0	0	0	0	0	0	0	0	0	0	0	0	0	0	0		批量查询
玛卡干片补肾 丽江	0	0	0	0	0	0	0	0	0	0	0	0	0	0	0		批量查询
玛卡干片 补肾延时	0	0	0	0	0	0	0	0	0	0	0	0	0	0	0		批量查询
云南玛卡干片补肾	0	0	0	0	0	0	0	0	0	0	0	0	0	0	0		批量查询
秘鲁引进玛卡干片	0	0	0	0	0	0	0	0	0	0	0	0	0	0	0		批量查询
玛卡 秘鲁 正品干片	0	0	0	0	0	0	0	0	0	0	0	0	0	0	0		批量查询
黑玛卡干片 秘鲁 正品	0	0	0	0	0	0	0	0	0	0	0	0	0	0	0		批量查询
紫玛卡干片 秘鲁	0	0	0	0	0	0	0	0	0	0	0	0	0	0	0		批量查询
秘鲁玛卡干片进口	0	0	0	0	0	0	0	0	0	0	0	0	0	0	0		批量查询
秘鲁黑玛卡进口干片	0	0	0	0	0	0	0	0	0	0	0	0	0	0	0		批量查询
玛卡秘鲁正品 卡干片	0	0	0	0	0	0	0	0	0	0	0	0	0	0	0		批量查询
秘鲁玛卡干片 延时	0	0	0	0	0	0	0	0	0	0	0	0	0	0	0		批量查询
秘鲁黑玛卡干片	0	0	0	0	0	0	0	0	0	0	0	0	0	0	0		批量查询
秘鲁玛卡种植技术	0	0	0	0	0	0	0	0	0	0	0	0	0	0	0		批量查询
男人玛卡干片50克	0	0	0	0	0	0	0	0	0	0	0	0	0	0	0		批量查询
送玛卡干片50克	0	0	0	0	0	0	0	0	0	0	0	0	0	0	0		批量查询
丽江玛卡干片50克	0	0	0	0	0	0	0	0	0	0	0	0	0	0	0		批量查询
紫玛卡干片包邮	0	0	0	0	0	0	0	0	0	0	0	0	0	0	0		批量查询
男人保健品 玛卡干片	0	0	0	0	0	0	0	0	0	0	0	0	0	0	0		批量查询
云南丽江黑玛卡干果	0	0	0	0	0	0	0	0	0	0	0	0	0	0	0		批量查询
丽江黑玛卡干果	0	0	0	0	0	0	0	0	0	0	0	0	0	0	0		批量查询
云南丽江玛卡干果	0	0	0	0	0	0	0	0	0	0	0	0	0	0	0		批量查询
丽江黄玛卡干果	0	0	0	0	0	0	0	0	0	0	0	0	0	0	0		批量查询
云南丽江黄玛卡干果	0	0	0	0	0	0	0	0	0	0	0	0	0	0	0		批量查询
秘鲁玛卡益康咀嚼片	0	0	0	0	0	0	0	0	0	0	0	0	0	0	0		批量查询
纯进口秘鲁玛卡干果	0	0	0	0	0	0	0	0	0	0	0	0	0	0	0		批量查询
秘鲁进口黄玛卡干果	0	0	0	0	0	0	0	0	0	0	0	0	0	0	0		批量查询
秘鲁进口紫玛卡干果	0	0	0	0	0	0	0	0	0	0	0	0	0	0	0		批量查询
秘鲁正品黑玛卡干果	0	0	0	0	0	0	0	0	0	0	0	0	0	0	0		批量查询
紫玛卡秘鲁正品 干果	0	0	0	0	0	0	0	0	0	0	0	0	0	0	0		批量查询
黄玛卡干果500g	0	0	0	0	0	0	0	0	0	0	0	0	0	0	0		批量查询
云南黄玛卡干果	0	0	0	0	0	0	0	0	0	0	0	0	0	0	0		批量查询
秘鲁玛卡有120粒的吗	0	0	0	0	0	0	0	0	0	0	0	0	0	0	0		批量查询
云南玛卡干果包邮	0	0	0	0	0	0	0	0	0	0	0	0	0	0	0		批量查询
玛卡 干果 云南极品	0	0	0	0	0	0	0	0	0	0	0	0	0	0	0		批量查询
云南黑玛卡干果	0	0	0	0	0	0	0	0	0	0	0	0	0	0	0		批量查询
玛卡秘鲁纯进口正品	0	0	0	0	0	0	0	0	0	0	0	0	0	0	0		批量查询
玛卡泡茶	0	0	0	0	0	0	0	0	0	0	0	0	0	0	0		批量查询
玛卡打粉吃多有效果	0	0	0	0	0	0	0	0	0	0	0	0	0	0	0		批量查询
黑玛卡秘鲁正品云南	0	0	0	0	0	0	0	0	0	0	0	0	0	0	0		批量查询
玛卡干果打粉后怎么吃	0	0	0	0	0	0	0	0	0	0	0	0	0	0	0		批量查询
玛卡 秘鲁正品拉摩力	0	0	0	0	0	0	0	0	0	0	0	0	0	0	0		批量查询
新疆玛卡价格	0	0	0	0	0	0	0	0	0	0	0	0	0	0	0		批量查询
新疆塔县玛卡种植基地	0	0	0	0	0	0	0	0	0	0	0	0	0	0	0		批量查询
新疆塔什库尔干县玛卡	0	0	0	0	0	0	0	0	0	0	0	0	0	0	0		批量查询
玛卡新疆哪里有种植	0	0	0	0	0	0	0	0	0	0	0	0	0	0	0		批量查询
新疆塔县玛卡	0	0	0	0	0	0	0	0	0	0	0	0	0	0	0		批量查询
新疆玛卡多少钱	0	0	0	0	0	0	0	0	0	0	0	0	0	0	0		批量查询
秘鲁玛卡新疆有售吗	0	0	0	0	0	0	0	0	0	0	0	0	0	0	0		批量查询
散装丽江玛卡干片	0	0	0	0	0	0	0	0	0	0	0	0	0	0	0		批量查询
丽江玛卡干片特价	0	0	0	0	0	0	0	0	0	0	0	0	0	0	0		批量查询
丽江玛卡干片 250	0	0	0	0	0	0	0	0	0	0	0	0	0	0	0		批量查询
云南丽江玛卡干片	0	0	0	0	0	0	0	0	0	0	0	0	0	0	0		批量查询
云南丽江黑玛卡干片	0	0	0	0	0	0	0	0	0	0	0	0	0	0	0		批量查询
丽江玛卡 玛咖干片	0	0	0	0	0	0	0	0	0	0	0	0	0	0	0		批量查询
丽江玛卡冻干片	0	0	0	0	0	0	0	0	0	0	0	0	0	0	0		批量查询
玛卡是片好还是粉好	0	0	0	0	0	0	0	0	0	0	0	0	0	0	0		批量查询
上方堂牌玛卡精片	0	0	0	0	0	0	0	0	0	0	0	0	0	0	0		批量查询
上方堂玛卡	0	0	0	0	0	0	0	0	0	0	0	0	0	0	0		批量查询
紫玛卡干片500g	0	0	0	0	0	0	0	0	0	0	0	0	0	0	0		批量查询
丽江紫玛卡干片	0	0	0	0	0	0	0	0	0	0	0	0	0	0	0		批量查询
云南紫玛卡干片	0	0	0	0	0	0	0	0	0	0	0	0	0	0	0		批量查询
云南丽江紫玛卡干片	0	0	0	0	0	0	0	0	0	0	0	0	0	0	0		批量查询
黄玛卡干片 250	0	0	0	0	0	0	0	0	0	0	0	0	0	0	0		批量查询
丽江 黄玛卡 干片	0	0	0	0	0	0	0	0	0	0	0	0	0	0	0		批量查询
巨青玛卡精招商电话	0	0	0	0	0	0	0	0	0	0	0	0	0	0	0		批量查询
巨精玛卡 清片	0	0	0	0	0	0	0	0	0	0	0	0	0	0	0		批量查询
云南玛卡干片礼盒装	0	0	0	0	0	0	0	0	0	0	0	0	0	0	0		批量查询
云南玛卡干片礼盒	0	0	0	0	0	0	0	0	0	0	0	0	0	0	0		批量查询
云南玛卡干片500g	0	0	0	0	0	0	0	0	0	0	0	0	0	0	0		批量查询
云南玛卡干片批发	0	0	0	0	0	0	0	0	0	0	0	0	0	0	0		批量查询
云南黑玛卡干片	0	0	0	0	0	0	0	0	0	0	0	0	0	0	0		批量查询
活力达玛卡的功效	0	0	0	0	0	0	0	0	0	0	0	0	0	0	0		批量查询
玛卡 活力达	0	0	0	0	0	0	0	0	0	0	0	0	0	0	0		批量查询
七福玛卡精片	0	0	0	0	0	0	0	0	0	0	0	0	0	0	0		批量查询
七福玛玛卡	0	0	0	0	0	0	0	0	0	0	0	0	0	0	0		批量查询
云南假玛卡 七福玛	0	0	0	0	0	0	0	0	0	0	0	0	0	0	0		批量查询
七福玛 玛卡的功效	0	0	0	0	0	0	0	0	0	0	0	0	0	0	0		批量查询
高原玛卡	0	0	0	0	0	0	0	0	0	0	0	0	0	0	0		批量查询
高原玛卡种植	0	0	0	0	0	0	0	0	0	0	0	0	0	0	0		批量查询
高原玛卡酒	0	0	0	0	0	0	0	0	0	0	0	0	0	0	0		批量查询
玛卡 秘鲁 正品代购	0	0	0	0	0	0	0	0	0	0	0	0	0	0	0		批量查询
玛卡 秘鲁正品散装	0	0	0	0	0	0	0	0	0	0	0	0	0	0	0		批量查询
玛卡 秘鲁 正品	0	0	0	0	0	0	0	0	0	0	0	0	0	0	0		批量查询
斯旺森玛卡胶囊	0	0	0	0	0	0	0	0	0	0	0	0	0	0	0		批量查询
奥秘鲁玛卡胶囊	0	0	0	0	0	0	0	0	0	0	0	0	0	0	0		批量查询
秘鲁玛卡 进口 补肾	0	0	0	0	0	0	0	0	0	0	0	0	0	0	0		批量查询
黑玛卡干果怎么吃	0	0	0	0	0	0	0	0	0	0	0	0	0	0	0		批量查询
元素玛卡	0	0	0	0	0	0	0	0	0	0	0	0	0	0	0		批量查询
云南玛卡中药材	0	0	0	0	0	0	0	0	0	0	0	0	0	0	0		批量查询
云南玛卡鲜果	0	0	0	0	0	0	0	0	0	0	0	0	0	0	0		批量查询
秘鲁玛卡片maca正品	0	0	0	0	0	0	0	0	0	0	0	0	0	0	0		批量查询
云南玛卡种子	0	0	0	0	0	0	0	0	0	0	0	0	0	0	0		批量查询
云南会泽玛卡	0	0	0	0	0	0	0	0	0	0	0	0	0	0	0		批量查询
云南玛卡原料	0	0	0	0	0	0	0	0	0	0	0	0	0	0	0		批量查询
新鲜玛卡怎么保存	0	0	0	0	0	0	0	0	0	0	0	0	0	0	0		批量查询
新鲜玛卡	0	0	0	0	0	0	0	0	0	0	0	0	0	0	0		批量查询
玛卡干片 泡酒方法	0	0	0	0	0	0	0	0	0	0	0	0	0	0	0		批量查询
玛卡粉一天吃几次	0	0	0	0	0	0	0	0	0	0	0	0	0	0	0		批量查询
玛卡粉一次吃多少	0	0	0	0	0	0	0	0	0	0	0	0	0	0	0		批量查询
云南玛卡一天吃多少	0	0	0	0	0	0	0	0	0	0	0	0	0	0	0		批量查询
玛卡干片一天吃多少克	0	0	0	0	0	0	0	0	0	0	0	0	0	0	0		批量查询
玛卡一天吃几次	0	0	0	0	0	0	0	0	0	0	0	0	0	0	0		批量查询
什么时间服用玛卡粉	0	0	0	0	0	0	0	0	0	0	0	0	0	0	0		批量查询
如何服用玛卡粉	0	0	0	0	0	0	0	0	0	0	0	0	0	0	0		批量查询
玛卡可以打成粉服用吗	0	0	0	0	0	0	0	0	0	0	0	0	0	0	0		批量查询
玛卡粉副的使用方法	0	0	0	0	0	0	0	0	0	0	0	0	0	0	0		批量查询
玛卡粉怎样吃效果最好	0	0	0	0	0	0	0	0	0	0	0	0	0	0	0		批量查询
女人吃玛卡好吗	0	0	0	0	0	0	0	0	0	0	0	0	0	0	0		批量查询
女人吃哪种玛卡比较好	0	0	0	0	0	0	0	0	0	0	0	0	0	0	0		批量查询
原药玛卡一次服用多少	0	0	0	0	0	0	0	0	0	0	0	0	0	0	0		批量查询
新鲜玛卡粉怎么食用	0	0	0	0	0	0	0	0	0	0	0	0	0	0	0		批量查询
玛卡粉食用	0	0	0	0	0	0	0	0	0	0	0	0	0	0	0		批量查询
玛卡粉怎么吃法	0	0	0	0	0	0	0	0	0	0	0	0	0	0	0		批量查询
松古树美玛卡玛咖	0	0	0	0	0	0	0	0	0	0	0	0	0	0	0		批量查询
秘鲁 玛卡代购	0	0	0	0	0	0	0	0	0	0	0	0	0	0	0		批量查询
秘鲁玛卡 中药	0	0	0	0	0	0	0	0	0	0	0	0	0	0	0		批量查询
秘鲁黑玛卡干果	0	0	0	0	0	0	0	0	0	0	0	0	0	0	0		批量查询
秘鲁 有机 玛卡干果	0	0	0	0	0	0	0	0	0	0	0	0	0	0	0		批量查询
玛咖 秘鲁野生玛卡	0	0	0	0	0	0	0	0	0	0	0	0	0	0	0		批量查询
秘鲁进口野生玛卡	0	0	0	0	0	0	0	0	0	0	0	0	0	0	0		批量查询
秘鲁野生玛卡一件代发	0	0	0	0	0	0	0	0	0	0	0	0	0	0	0		批量查询
秘鲁野生黑玛卡	0	0	0	0	0	0	0	0	0	0	0	0	0	0	0		批量查询
拉摩力拉牌秘鲁玛卡	0	0	0	0	0	0	0	0	0	0	0	0	0	0	0		批量查询
秘鲁拉摩力拉玛卡60	0	0	0	0	0	0	0	0	0	0	0	0	0	0	0		批量查询
丽江玛卡干果怎么吃	0	0	0	0	0	0	0	0	0	0	0	0	0	0	0		批量查询
丽江玛卡干果的功效	0	0	0	0	0	0	0	0	0	0	0	0	0	0	0		批量查询
黄玛卡干果图片	0	0	0	0	0	0	0	0	0	0	0	0	0	0	0		批量查询
云南产玛卡干果咋食用	0	0	0	0	0	0	0	0	0	0	0	0	0	0	0		批量查询
玛卡瑞纳 原版伴奏	0	0	0	0	0	0	0	0	0	0	0	0	0	0	0		批量查询
那个品牌的秘鲁玛卡好	0	0	0	0	0	0	0	0	0	0	0	0	0	0	0		批量查询
正品玛卡秘鲁黑玛咖	0	0	0	0	0	0	0	0	0	0	0	0	0	0	0		批量查询
秘鲁玛卡 60	0	0	0	0	0	0	0	0	0	0	0	0	0	0	0		批量查询
秘鲁拉摩力拉牌玛卡	0	0	0	0	0	0	0	0	0	0	0	0	0	0	0		批量查询
云南玛卡和秘鲁玛卡	0	0	0	0	0	0	0	0	0	0	0	0	0	0	0		批量查询
云南元素玛卡干片	0	0	0	0	0	0	0	0	0	0	0	0	0	0	0		批量查询
女性 云南元素玛卡	0	0	0	0	0	0	0	0	0	0	0	0	0	0	0		批量查询
拉摩力拉牌玛卡官网	0	0	0	0	0	0	0	0	0	0	0	0	0	0	0		批量查询
玛卡片 正品 原装进口	0	0	0	0	0	0	0	0	0	0	0	0	0	0	0		批量查询
日本玛卡男人保健品	0	0	0	0	0	0	0	0	0	0	0	0	0	0	0		批量查询
保健品 玛卡 玛咖 补肾	0	0	0	0	0	0	0	0	0	0	0	0	0	0	0		批量查询
玛卡补肾男士保健品	0	0	0	0	0	0	0	0	0	0	0	0	0	0	0		批量查询
男保健品 补肾 玛卡	0	0	0	0	0	0	0	0	0	0	0	0	0	0	0		批量查询
男性保健品补肾玛卡	0	0	0	0	0	0	0	0	0	0	0	0	0	0	0		批量查询
美国玛卡男性保健品	0	0	0	0	0	0	0	0	0	0	0	0	0	0	0		批量查询
男性保健品 男用 玛卡	0	0	0	0	0	0	0	0	0	0	0	0	0	0	0		批量查询
男性保健品延时 玛卡	0	0	0	0	0	0	0	0	0	0	0	0	0	0	0		批量查询
男人男性保健品玛卡	0	0	0	0	0	0	0	0	0	0	0	0	0	0	0		批量查询
男性保健品 玛卡 持久	0	0	0	0	0	0	0	0	0	0	0	0	0	0	0		批量查询
保健品 男性玛卡	0	0	0	0	0	0	0	0	0	0	0	0	0	0	0		批量查询
男用玛卡男人保健品	0	0	0	0	0	0	0	0	0	0	0	0	0	0	0		批量查询
云南玛卡男人保健品	0	0	0	0	0	0	0	0	0	0	0	0	0	0	0		批量查询
男人性保健品 玛卡	0	0	0	0	0	0	0	0	0	0	0	0	0	0	0		批量查询
正品男人保健品玛卡	0	0	0	0	0	0	0	0	0	0	0	0	0	0	0		批量查询
男人保健品玛卡秘鲁正品玛咖精片	0	0	0	0	0	0	0	0	0	0	0	0	0	0	0		批量查询
性保健品 男用 玛卡	0	0	0	0	0	0	0	0	0	0	0	0	0	0	0		批量查询
延时玛卡保健品男用	0	0	0	0	0	0	0	0	0	0	0	0	0	0	0		批量查询
云南会泽县玛卡种植	0	0	0	0	0	0	0	0	0	0	0	0	0	0	0		批量查询
会泽玛卡价格	0	0	0	0	0	0	0	0	0	0	0	0	0	0	0		批量查询
会泽大海玛卡图片	0	0	0	0	0	0	0	0	0	0	0	0	0	0	0		批量查询
会泽大桥乡玛卡图片	0	0	0	0	0	0	0	0	0	0	0	0	0	0	0		批量查询
会泽玛卡种植	0	0	0	0	0	0	0	0	0	0	0	0	0	0	0		批量查询
黑玛卡副作用	0	0	0	0	0	0	0	0	0	0	0	0	0	0	0		批量查询
玛卡干果怎么吃最好	0	0	0	0	0	0	0	0	0	0	0	0	0	0	0		批量查询
玛卡干果怎么吃 图	0	0	0	0	0	0	0	0	0	0	0	0	0	0	0		批量查询
玛卡干果哪种好	0	0	0	0	0	0	0	0	0	0	0	0	0	0	0		批量查询
玛卡干果泡酒法	0	0	0	0	0	0	0	0	0	0	0	0	0	0	0		批量查询
玛卡干果泡酒	0	0	0	0	0	0	0	0	0	0	0	0	0	0	0		批量查询
玛卡干果如何食用	0	0	0	0	0	0	0	0	0	0	0	0	0	0	0		批量查询
玛卡干果才95一斤	0	0	0	0	0	0	0	0	0	0	0	0	0	0	0		批量查询
玛卡干果多少钱一斤	0	0	0	0	0	0	0	0	0	0	0	0	0	0	0		批量查询
一公斤玛卡干果起批	0	0	0	0	0	0	0	0	0	0	0	0	0	0	0		批量查询
玛卡干果多少钱一公斤	0	0	0	0	0	0	0	0	0	0	0	0	0	0	0		批量查询
玛卡玛咖maca	0	0	0	0	0	0	0	0	0	0	0	0	0	0	0		批量查询
玛卡玛咖干片哥	0	0	0	0	0	0	0	0	0	0	0	0	0	0	0		批量查询
玛卡玛咖片	0	0	0	0	0	0	0	0	0	0	0	0	0	0	0		批量查询
玛卡玛咖伟干片	0	0	0	0	0	0	0	0	0	0	0	0	0	0	0		批量查询
玛卡玛咖maca 干果	0	0	0	0	0	0	0	0	0	0	0	0	0	0	0		批量查询
玛卡玛咖干片哥性	0	0	0	0	0	0	0	0	0	0	0	0	0	0	0		批量查询
玛卡玛咖干	0	0	0	0	0	0	0	0	0	0	0	0	0	0	0		批量查询
玛卡玛咖粉超细	0	0	0	0	0	0	0	0	0	0	0	0	0	0	0		批量查询
玛卡吃法	0	0	0	0	0	0	0	0	0	0	0	0	0	0	0		批量查询
玛卡 玛咖 干果	0	0	0	0	0	0	0	0	0	0	0	0	0	0	0		批量查询
玛卡 玛咖片	0	0	0	0	0	0	0	0	0	0	0	0	0	0	0		批量查询
玛卡玛咖高原高纯度精片	0	0	0	0	0	0	0	0	0	0	0	0	0	0	0		批量查询
松古树美 玛卡玛咖片	0	0	0	0	0	0	0	0	0	0	0	0	0	0	0		批量查询
玛卡玛咖女士用	0	0	0	0	0	0	0	0	0	0	0	0	0	0	0		批量查询
松古树美 男性玛卡玛咖	0	0	0	0	0	0	0	0	0	0	0	0	0	0	0		批量查询
中药玛卡功效	0	0	0	0	0	0	0	0	0	0	0	0	0	0	0		批量查询
拉摩力拉牌玛卡有效吗	0	0	0	0	0	0	0	0	0	0	0	0	0	0	0		批量查询
拉摩力拉牌玛卡 真伪	0	0	0	0	0	0	0	0	0	0	0	0	0	0	0		批量查询
玛卡片30片	0	0	0	0	0	0	0	0	0	0	0	0	0	0	0		批量查询
云南玛卡是什么植物	0	0	0	0	0	0	0	0	0	0	0	0	0	0	0		批量查询
云南玛卡功效简介	0	0	0	0	0	0	0	0	0	0	0	0	0	0	0		批量查询
云南丽江玛卡功效	0	0	0	0	0	0	0	0	0	0	0	0	0	0	0		批量查询
云南玛卡泡酒功效	0	0	0	0	0	0	0	0	0	0	0	0	0	0	0		批量查询
云南玛卡种植技术	0	0	0	0	0	0	0	0	0	0	0	0	0	0	0		批量查询
云南玛卡种植合作社	0	0	0	0	0	0	0	0	0	0	0	0	0	0	0		批量查询
云南玛卡种植条件	0	0	0	0	0	0	0	0	0	0	0	0	0	0	0		批量查询
云南玛卡种植信息网	0	0	0	0	0	0	0	0	0	0	0	0	0	0	0		批量查询
云南昭通玛卡种植	0	0	0	0	0	0	0	0	0	0	0	0	0	0	0		批量查询
云南哪些地方种植玛卡	0	0	0	0	0	0	0	0	0	0	0	0	0	0	0		批量查询
云南最大种植玛卡公司	0	0	0	0	0	0	0	0	0	0	0	0	0	0	0		批量查询
黄金玛卡maca保健品	0	0	0	0	0	0	0	0	0	0	0	0	0	0	0		批量查询
男性保健品 黄金玛卡	0	0	0	0	0	0	0	0	0	0	0	0	0	0	0		批量查询
男用黄金玛卡保健品	0	0	0	0	0	0	0	0	0	0	0	0	0	0	0		批量查询
性保健品黄金玛卡	0	0	0	0	0	0	0	0	0	0	0	0	0	0	0		批量查询
云南药材玛卡图片	0	0	0	0	0	0	0	0	0	0	0	0	0	0	0		批量查询
云南玛卡植物图片	0	0	0	0	0	0	0	0	0	0	0	0	0	0	0		批量查询
帕米尔玛卡干片怎么吃	0	0	0	0	0	0	0	0	0	0	0	0	0	0	0		批量查询
玛卡干片可以嚼着吃吗	0	0	0	0	0	0	0	0	0	0	0	0	0	0	0		批量查询
吃玛卡干片有作用吗	0	0	0	0	0	0	0	0	0	0	0	0	0	0	0		批量查询
玛卡干片吃多久有效	0	0	0	0	0	0	0	0	0	0	0	0	0	0	0		批量查询
玛卡干片如何吃	0	0	0	0	0	0	0	0	0	0	0	0	0	0	0		批量查询
玛卡干片泡水方法	0	0	0	0	0	0	0	0	0	0	0	0	0	0	0		批量查询
玛卡干片的吃法	0	0	0	0	0	0	0	0	0	0	0	0	0	0	0		批量查询
玛卡怎么吃有辣嘴味道	0	0	0	0	0	0	0	0	0	0	0	0	0	0	0		批量查询
玛卡干片泡茶	0	0	0	0	0	0	0	0	0	0	0	0	0	0	0		批量查询
玛卡干片 效果	0	0	0	0	0	0	0	0	0	0	0	0	0	0	0		批量查询
玛卡泡茶喝有什么效果	0	0	0	0	0	0	0	0	0	0	0	0	0	0	0		批量查询
玛卡煲汤	0	0	0	0	0	0	0	0	0	0	0	0	0	0	0		批量查询
玛卡包装盒定做	0	0	0	0	0	0	0	0	0	0	0	0	0	0	0		批量查询
玛卡礼品包装盒	0	0	0	0	0	0	0	0	0	0	0	0	0	0	0		批量查询
玛卡空礼盒 包装盒	0	0	0	0	0	0	0	0	0	0	0	0	0	0	0		批量查询
云南玛卡包装盒	0	0	0	0	0	0	0	0	0	0	0	0	0	0	0		批量查询
装玛卡礼品包装盒	0	0	0	0	0	0	0	0	0	0	0	0	0	0	0		批量查询
玛卡塑料包装盒	0	0	0	0	0	0	0	0	0	0	0	0	0	0	0		批量查询
黑玛卡干片	0	0	0	0	0	0	0	0	0	0	0	0	0	0	0		批量查询
玛卡干片批发	0	0	0	0	0	0	0	0	0	0	0	0	0	0	0		批量查询
玛卡种植方法	0	0	0	0	0	0	0	0	0	0	0	0	0	0	0		批量查询
玛卡种植效益	0	0	0	0	0	0	0	0	0	0	0	0	0	0	0		批量查询
玛卡包装袋自封	0	0	0	0	0	0	0	0	0	0	0	0	0	0	0		批量查询
玛卡礼盒包装盒	0	0	0	0	0	0	0	0	0	0	0	0	0	0	0		批量查询
黄金玛卡包装盒	0	0	0	0	0	0	0	0	0	0	0	0	0	0	0		批量查询
厂家直销玛卡包装盒	0	0	0	0	0	0	0	0	0	0	0	0	0	0	0		批量查询
秘鲁玛卡包装盒	0	0	0	0	0	0	0	0	0	0	0	0	0	0	0		批量查询
玛卡小瓶包装	0	0	0	0	0	0	0	0	0	0	0	0	0	0	0		批量查询
玛卡包装木盒子	0	0	0	0	0	0	0	0	0	0	0	0	0	0	0		批量查询
秘鲁玛卡保健品	0	0	0	0	0	0	0	0	0	0	0	0	0	0	0		批量查询
秘鲁玛卡提取物	0	0	0	0	0	0	0	0	0	0	0	0	0	0	0		批量查询
秘鲁玛卡maca	0	0	0	0	0	0	0	0	0	0	0	0	0	0	0		批量查询
云南玛卡如何泡酒	0	0	0	0	0	0	0	0	0	0	0	0	0	0	0		批量查询
云南玛卡泡酒的配料	0	0	0	0	0	0	0	0	0	0	0	0	0	0	0		批量查询
云南玛卡怎么泡酒	0	0	0	0	0	0	0	0	0	0	0	0	0	0	0		批量查询
云南玛卡泡酒方法	0	0	0	0	0	0	0	0	0	0	0	0	0	0	0		批量查询
云南丽江玛卡生产企业	0	0	0	0	0	0	0	0	0	0	0	0	0	0	0		批量查询
云南丽江玛卡的作用	0	0	0	0	0	0	0	0	0	0	0	0	0	0	0		批量查询
和布克赛尔之歌玛卡	0	0	0	0	0	0	0	0	0	0	0	0	0	0	0		批量查询
秘鲁野生玛卡鉴别	0	0	0	0	0	0	0	0	0	0	0	0	0	0	0		批量查询
拉摩力拉黑玛卡招商	0	0	0	0	0	0	0	0	0	0	0	0	0	0	0		批量查询
拉摩力玛卡真的有效吗	0	0	0	0	0	0	0	0	0	0	0	0	0	0	0		批量查询
玛卡做法	0	0	0	0	0	0	0	0	0	0	0	0	0	0	0		批量查询
活力达秘鲁进口玛卡精片90片/瓶	0	0	0	0	0	0	0	0	0	0	0	0	0	0	0		批量查询
秘鲁玛卡含片	0	0	0	0	0	0	0	0	0	0	0	0	0	0	0		批量查询
玛卡生长条件	0	0	0	0	0	0	0	0	0	0	0	0	0	0	0		批量查询
宝宝能吃玛卡煮肉吗	0	0	0	0	0	0	0	0	0	0	0	0	0	0	0		批量查询
保健品玛卡喷剂	0	0	0	0	0	0	0	0	0	0	0	0	0	0	0		批量查询
玛卡保健品批发	0	0	0	0	0	0	0	0	0	0	0	0	0	0	0		批量查询
玛卡谁吃过管用吗	0	0	0	0	0	0	0	0	0	0	0	0	0	0	0		批量查询
玛卡片干片	0	0	0	0	0	0	0	0	0	0	0	0	0	0	0		批量查询
秘鲁玛卡谁吃过	0	0	0	0	0	0	0	0	0	0	0	0	0	0	0		批量查询
玛卡秘鲁有人吃过没	0	0	0	0	0	0	0	0	0	0	0	0	0	0	0		批量查询
有吃过玛卡的女性吗	0	0	0	0	0	0	0	0	0	0	0	0	0	0	0		批量查询
有人吃过玛卡吗	0	0	0	0	0	0	0	0	0	0	0	0	0	0	0		批量查询
吃过玛卡的说说	0	0	0	0	0	0	0	0	0	0	0	0	0	0	0		批量查询
保健品玛卡秘鲁正品干片	0	0	0	0	0	0	0	0	0	0	0	0	0	0	0		批量查询
秘鲁玛卡要到哪买	0	0	0	0	0	0	0	0	0	0	0	0	0	0	0		批量查询
玛卡产地	0	0	0	0	0	0	0	0	0	0	0	0	0	0	0		批量查询
玛卡片秘鲁保健品	0	0	0	0	0	0	0	0	0	0	0	0	0	0	0		批量查询
玛卡真伪查询	0	0	0	0	0	0	0	0	0	0	0	0	0	0	0		批量查询
秘鲁玛卡真伪查询	0	0	0	0	0	0	0	0	0	0	0	0	0	0	0		批量查询
玛卡真伪如何辨别	0	0	0	0	0	0	0	0	0	0	0	0	0	0	0		批量查询
怎么 识别 玛卡真伪	0	0	0	0	0	0	0	0	0	0	0	0	0	0	0		批量查询
玛卡的真伪	0	0	0	0	0	0	0	0	0	0	0	0	0	0	0		批量查询
玛卡的真伪视频	0	0	0	0	0	0	0	0	0	0	0	0	0	0	0		批量查询
玛卡辨别真伪视频	0	0	0	0	0	0	0	0	0	0	0	0	0	0	0		批量查询
玛卡 真伪鉴别	0	0	0	0	0	0	0	0	0	0	0	0	0	0	0		批量查询
玛卡 女性	0	0	0	0	0	0	0	0	0	0	0	0	0	0	0		批量查询
玛卡 女	0	0	0	0	0	0	0	0	0	0	0	0	0	0	0		批量查询
玛卡西尼新款	0	0	0	0	0	0	0	0	0	0	0	0	0	0	0		批量查询
云南 玛卡 多少钱一克	0	0	0	0	0	0	0	0	0	0	0	0	0	0	0		批量查询
玛卡片干片干果	0	0	0	0	0	0	0	0	0	0	0	0	0	0	0		批量查询
秘鲁玛卡多少钱一克	0	0	0	0	0	0	0	0	0	0	0	0	0	0	0		批量查询
玛卡药材多少钱一克	0	0	0	0	0	0	0	0	0	0	0	0	0	0	0		批量查询
玛卡果多少钱一克 图	0	0	0	0	0	0	0	0	0	0	0	0	0	0	0		批量查询
玛卡1克多少钱	0	0	0	0	0	0	0	0	0	0	0	0	0	0	0		批量查询
云南玛卡一次吃多少量	0	0	0	0	0	0	0	0	0	0	0	0	0	0	0		批量查询
云南玛卡怎样吃	0	0	0	0	0	0	0	0	0	0	0	0	0	0	0		批量查询
云南玛卡干怎么吃	0	0	0	0	0	0	0	0	0	0	0	0	0	0	0		批量查询
云南雪鼎玛卡有作用吗	0	0	0	0	0	0	0	0	0	0	0	0	0	0	0		批量查询
新鲜玛卡如何吃	0	0	0	0	0	0	0	0	0	0	0	0	0	0	0		批量查询
新鲜玛卡怎样吃好些	0	0	0	0	0	0	0	0	0	0	0	0	0	0	0		批量查询
新鲜玛卡怎么吃有效	0	0	0	0	0	0	0	0	0	0	0	0	0	0	0		批量查询
丽江玛卡种植户123	0	0	0	0	0	0	0	0	0	0	0	0	0	0	0		批量查询
丽江玛卡种植户	0	0	0	0	0	0	0	0	0	0	0	0	0	0	0		批量查询
玛卡益康片效果怎样	0	0	0	0	0	0	0	0	0	0	0	0	0	0	0		批量查询
玛卡烯 玛卡酰胺	0	0	0	0	0	0	0	0	0	0	0	0	0	0	0		批量查询
玛卡益康片药店有卖吗	0	0	0	0	0	0	0	0	0	0	0	0	0	0	0		批量查询
植物玛卡的功效	0	0	0	0	0	0	0	0	0	0	0	0	0	0	0		批量查询
植物玛卡是什么味道	0	0	0	0	0	0	0	0	0	0	0	0	0	0	0		批量查询
植物玛卡是怎样生长的	0	0	0	0	0	0	0	0	0	0	0	0	0	0	0		批量查询
玛卡植物怎么吃	0	0	0	0	0	0	0	0	0	0	0	0	0	0	0		批量查询
纯天然玛卡的食用方法	0	0	0	0	0	0	0	0	0	0	0	0	0	0	0		批量查询
伽玛卡兹中国代理	0	0	0	0	0	0	0	0	0	0	0	0	0	0	0		批量查询
广州伽玛卡兹	0	0	0	0	0	0	0	0	0	0	0	0	0	0	0		批量查询
秘鲁天然玛卡怎么样	0	0	0	0	0	0	0	0	0	0	0	0	0	0	0		批量查询
秘鲁玛卡谁用过怎么样	0	0	0	0	0	0	0	0	0	0	0	0	0	0	0		批量查询
玛卡益康片真的有效吗	0	0	0	0	0	0	0	0	0	0	0	0	0	0	0		批量查询
玛卡玛咖干果多少一斤	0	0	0	0	0	0	0	0	0	0	0	0	0	0	0		批量查询
玛卡玛咖有用吗	0	0	0	0	0	0	0	0	0	0	0	0	0	0	0		批量查询
玛卡玛咖是什么	0	0	0	0	0	0	0	0	0	0	0	0	0	0	0		批量查询
男性玛卡玛咖	0	0	0	0	0	0	0	0	0	0	0	0	0	0	0		批量查询
植物玛卡玛咖黄精	0	0	0	0	0	0	0	0	0	0	0	0	0	0	0		批量查询
男性玛卡玛咖是什么	0	0	0	0	0	0	0	0	0	0	0	0	0	0	0		批量查询
美国玛卡玛咖伟干片哥	0	0	0	0	0	0	0	0	0	0	0	0	0	0	0		批量查询
玛卡玛咖怎么样	0	0	0	0	0	0	0	0	0	0	0	0	0	0	0		批量查询
玛卡西女童装	0	0	0	0	0	0	0	0	0	0	0	0	0	0	0		批量查询
吃玛卡的副作用	0	0	0	0	0	0	0	0	0	0	0	0	0	0	0		批量查询
中药玛卡的副作用	0	0	0	0	0	0	0	0	0	0	0	0	0	0	0		批量查询
玛卡益康片能长期吃吗	0	0	0	0	0	0	0	0	0	0	0	0	0	0	0		批量查询
云南玛卡的副作用	0	0	0	0	0	0	0	0	0	0	0	0	0	0	0		批量查询
玛卡瑞纳 什么意思	0	0	0	0	0	0	0	0	0	0	0	0	0	0	0		批量查询
轩庆玛卡	0	0	0	0	0	0	0	0	0	0	0	0	0	0	0		批量查询
玛卡西尼男装风衣	0	0	0	0	0	0	0	0	0	0	0	0	0	0	0		批量查询
玛卡西尼男装羽绒服	0	0	0	0	0	0	0	0	0	0	0	0	0	0	0		批量查询
玛卡西尼男装外套	0	0	0	0	0	0	0	0	0	0	0	0	0	0	0		批量查询
玛卡西尼正品男装 春	0	0	0	0	0	0	0	0	0	0	0	0	0	0	0		批量查询
玛卡西尼衬衫 男装	0	0	0	0	0	0	0	0	0	0	0	0	0	0	0		批量查询
玛卡西尼夏季男装	0	0	0	0	0	0	0	0	0	0	0	0	0	0	0		批量查询
2014玛卡西尼男装	0	0	0	0	0	0	0	0	0	0	0	0	0	0	0		批量查询
玛卡益康片厦门	0	0	0	0	0	0	0	0	0	0	0	0	0	0	0		批量查询
玛卡胶囊多少钱一瓶	0	0	0	0	0	0	0	0	0	0	0	0	0	0	0		批量查询
玛卡精片 补肾	0	0	0	0	0	0	0	0	0	0	0	0	0	0	0		批量查询
玛卡精片保健品男性	0	0	0	0	0	0	0	0	0	0	0	0	0	0	0		批量查询
玛卡一瓶多少粒	0	0	0	0	0	0	0	0	0	0	0	0	0	0	0		批量查询
玛卡1瓶多少钱	0	0	0	0	0	0	0	0	0	0	0	0	0	0	0		批量查询
丽江玛卡批发	0	0	0	0	0	0	0	0	0	0	0	0	0	0	0		批量查询
昆明玛卡批发	0	0	0	0	0	0	0	0	0	0	0	0	0	0	0		批量查询
拉摩力拉玛卡片60	0	0	0	0	0	0	0	0	0	0	0	0	0	0	0		批量查询
玛卡精片简装	0	0	0	0	0	0	0	0	0	0	0	0	0	0	0		批量查询
玛卡西尼时尚休闲男装	0	0	0	0	0	0	0	0	0	0	0	0	0	0	0		批量查询
玛卡精片 男人	0	0	0	0	0	0	0	0	0	0	0	0	0	0	0		批量查询
玛米玛卡男童春装	0	0	0	0	0	0	0	0	0	0	0	0	0	0	0		批量查询
玛米玛卡男童牛仔裤	0	0	0	0	0	0	0	0	0	0	0	0	0	0	0		批量查询
玛米玛卡男童短袖	0	0	0	0	0	0	0	0	0	0	0	0	0	0	0		批量查询
玛米玛卡男童t恤	0	0	0	0	0	0	0	0	0	0	0	0	0	0	0		批量查询
玛米玛卡男童长裤	0	0	0	0	0	0	0	0	0	0	0	0	0	0	0		批量查询
玛米玛卡男童裤子	0	0	0	0	0	0	0	0	0	0	0	0	0	0	0		批量查询
玛米玛卡男童短裤	0	0	0	0	0	0	0	0	0	0	0	0	0	0	0		批量查询
玛米玛卡女童连衣裙	0	0	0	0	0	0	0	0	0	0	0	0	0	0	0		批量查询
玛米玛卡女童t恤	0	0	0	0	0	0	0	0	0	0	0	0	0	0	0		批量查询
玛米玛卡女童2014春	0	0	0	0	0	0	0	0	0	0	0	0	0	0	0		批量查询
玛米玛卡女童衬衫	0	0	0	0	0	0	0	0	0	0	0	0	0	0	0		批量查询
玛米玛卡女童裙子	0	0	0	0	0	0	0	0	0	0	0	0	0	0	0		批量查询
玛卡粉hs编码	0	0	0	0	0	0	0	0	0	0	0	0	0	0	0		批量查询
玛米玛卡 女童 裤	0	0	0	0	0	0	0	0	0	0	0	0	0	0	0		批量查询
玛米玛卡 女 外套	0	0	0	0	0	0	0	0	0	0	0	0	0	0	0		批量查询
玛米玛卡 女童 棉衣	0	0	0	0	0	0	0	0	0	0	0	0	0	0	0		批量查询
玛米玛卡 女 裙	0	0	0	0	0	0	0	0	0	0	0	0	0	0	0		批量查询
玛米玛卡 女 条纹t恤	0	0	0	0	0	0	0	0	0	0	0	0	0	0	0		批量查询
玛米玛卡 女童棉马甲	0	0	0	0	0	0	0	0	0	0	0	0	0	0	0		批量查询
玛米玛卡 女 卫衣	0	0	0	0	0	0	0	0	0	0	0	0	0	0	0		批量查询
玛米玛卡 女童 长袖t	0	0	0	0	0	0	0	0	0	0	0	0	0	0	0		批量查询
玛米玛卡 女童 棉服	0	0	0	0	0	0	0	0	0	0	0	0	0	0	0		批量查询
玛米玛卡 女童 160	0	0	0	0	0	0	0	0	0	0	0	0	0	0	0		批量查询
玛卡种子供应	0	0	0	0	0	0	0	0	0	0	0	0	0	0	0		批量查询
玛米玛卡女童春款	0	0	0	0	0	0	0	0	0	0	0	0	0	0	0		批量查询
玛米玛卡女童棉衣	0	0	0	0	0	0	0	0	0	0	0	0	0	0	0		批量查询
玛米玛卡男童毛衣	0	0	0	0	0	0	0	0	0	0	0	0	0	0	0		批量查询
玛米玛卡女童毛衣	0	0	0	0	0	0	0	0	0	0	0	0	0	0	0		批量查询
玛米玛卡女大童毛衣	0	0	0	0	0	0	0	0	0	0	0	0	0	0	0		批量查询
玛卡用法用量	0	0	0	0	0	0	0	0	0	0	0	0	0	0	0		批量查询
玛米玛卡女童羽绒服	0	0	0	0	0	0	0	0	0	0	0	0	0	0	0		批量查询
玛米玛卡正品羽绒服	0	0	0	0	0	0	0	0	0	0	0	0	0	0	0		批量查询
西安有卖玛卡的药店吗	0	0	0	0	0	0	0	0	0	0	0	0	0	0	0		批量查询
玛卡使用方法	0	0	0	0	0	0	0	0	0	0	0	0	0	0	0		批量查询
拉摩力拉玛卡 60粒	0	0	0	0	0	0	0	0	0	0	0	0	0	0	0		批量查询
玛卡 拉摩力拉 60精片	0	0	0	0	0	0	0	0	0	0	0	0	0	0	0		批量查询
玛卡的宣传设计网站	0	0	0	0	0	0	0	0	0	0	0	0	0	0	0		批量查询
玛卡的宣传设计	0	0	0	0	0	0	0	0	0	0	0	0	0	0	0		批量查询
拉摩力拉玛卡30片	0	0	0	0	0	0	0	0	0	0	0	0	0	0	0		批量查询
拉摩力拉玛卡30粒	0	0	0	0	0	0	0	0	0	0	0	0	0	0	0		批量查询
玛卡益康片有副作用吗	0	0	0	0	0	0	0	0	0	0	0	0	0	0	0		批量查询
玛卡益康片副作用	0	0	0	0	0	0	0	0	0	0	0	0	0	0	0		批量查询
玛卡亚米百度百科	0	0	0	0	0	0	0	0	0	0	0	0	0	0	0		批量查询
玛卡的生产厂家	0	0	0	0	0	0	0	0	0	0	0	0	0	0	0		批量查询
伽玛卡兹鱼竿 正品	0	0	0	0	0	0	0	0	0	0	0	0	0	0	0		批量查询
伽玛卡兹鱼竿 进口	0	0	0	0	0	0	0	0	0	0	0	0	0	0	0		批量查询
gamakatsu 伽玛卡兹鱼竿	0	0	0	0	0	0	0	0	0	0	0	0	0	0	0		批量查询
日本伽玛卡兹鱼竿	0	0	0	0	0	0	0	0	0	0	0	0	0	0	0		批量查询
伽玛卡兹凌波鱼竿	0	0	0	0	0	0	0	0	0	0	0	0	0	0	0		批量查询
伽玛卡兹6.3鱼竿	0	0	0	0	0	0	0	0	0	0	0	0	0	0	0		批量查询
玛卡招商电话	0	0	0	0	0	0	0	0	0	0	0	0	0	0	0		批量查询
伊势尼伽玛卡兹鱼钩	0	0	0	0	0	0	0	0	0	0	0	0	0	0	0		批量查询
伽玛卡兹鱼钩伊势尼	0	0	0	0	0	0	0	0	0	0	0	0	0	0	0		批量查询
伽玛卡兹鱼钩 伊豆	0	0	0	0	0	0	0	0	0	0	0	0	0	0	0		批量查询
伽玛卡兹鱼钩 盒装	0	0	0	0	0	0	0	0	0	0	0	0	0	0	0		批量查询
伽玛卡兹鱼钩溪流	0	0	0	0	0	0	0	0	0	0	0	0	0	0	0		批量查询
伽玛卡兹鱼钩鲤用	0	0	0	0	0	0	0	0	0	0	0	0	0	0	0		批量查询
伽玛卡兹鱼钩赤 伊豆	0	0	0	0	0	0	0	0	0	0	0	0	0	0	0		批量查询
伽玛卡兹鱼钩 角	0	0	0	0	0	0	0	0	0	0	0	0	0	0	0		批量查询
伽玛卡兹鱼钩 白袖钩	0	0	0	0	0	0	0	0	0	0	0	0	0	0	0		批量查询
玛卡酒怎么泡	0	0	0	0	0	0	0	0	0	0	0	0	0	0	0		批量查询
玛米玛卡正品女童春	0	0	0	0	0	0	0	0	0	0	0	0	0	0	0		批量查询
玛米玛卡女童正品	0	0	0	0	0	0	0	0	0	0	0	0	0	0	0		批量查询
玛米玛卡专柜正品	0	0	0	0	0	0	0	0	0	0	0	0	0	0	0		批量查询
玛米玛卡男童正品	0	0	0	0	0	0	0	0	0	0	0	0	0	0	0		批量查询
玛米玛卡棉服正品	0	0	0	0	0	0	0	0	0	0	0	0	0	0	0		批量查询
玛米玛卡专柜正品女	0	0	0	0	0	0	0	0	0	0	0	0	0	0	0		批量查询
正品玛米玛卡夏装	0	0	0	0	0	0	0	0	0	0	0	0	0	0	0		批量查询
功能类似玛卡	0	0	0	0	0	0	0	0	0	0	0	0	0	0	0		批量查询
拉摩力拉玛卡加盟	0	0	0	0	0	0	0	0	0	0	0	0	0	0	0		批量查询
拉摩力拉玛卡经销	0	0	0	0	0	0	0	0	0	0	0	0	0	0	0		批量查询
玛卡果吃法	0	0	0	0	0	0	0	0	0	0	0	0	0	0	0		批量查询
玛卡的作用和吃法	0	0	0	0	0	0	0	0	0	0	0	0	0	0	0		批量查询
玛米玛卡女童外套秋	0	0	0	0	0	0	0	0	0	0	0	0	0	0	0		批量查询
玛米玛卡女童外套春	0	0	0	0	0	0	0	0	0	0	0	0	0	0	0		批量查询
男童外套春 玛米玛卡	0	0	0	0	0	0	0	0	0	0	0	0	0	0	0		批量查询
玛米玛卡男童秋外套	0	0	0	0	0	0	0	0	0	0	0	0	0	0	0		批量查询
玛米玛卡男童薄外套	0	0	0	0	0	0	0	0	0	0	0	0	0	0	0		批量查询
玛米玛卡 大 男童 外套	0	0	0	0	0	0	0	0	0	0	0	0	0	0	0		批量查询
女人吃玛卡功效	0	0	0	0	0	0	0	0	0	0	0	0	0	0	0		批量查询
玛卡功效 做法 大全	0	0	0	0	0	0	0	0	0	0	0	0	0	0	0		批量查询
玛卡功效怎么样	0	0	0	0	0	0	0	0	0	0	0	0	0	0	0		批量查询
玛卡女的可以吃吗	0	0	0	0	0	0	0	0	0	0	0	0	0	0	0		批量查询
女的能吃玛卡吗	0	0	0	0	0	0	0	0	0	0	0	0	0	0	0		批量查询
玛卡西童装 男童	0	0	0	0	0	0	0	0	0	0	0	0	0	0	0		批量查询
玛卡西童装衬衫	0	0	0	0	0	0	0	0	0	0	0	0	0	0	0		批量查询
玛卡西童装男衬衫	0	0	0	0	0	0	0	0	0	0	0	0	0	0	0		批量查询
玛卡西童装男	0	0	0	0	0	0	0	0	0	0	0	0	0	0	0		批量查询
玛卡西童装西装	0	0	0	0	0	0	0	0	0	0	0	0	0	0	0		批量查询
玛卡西童装春装	0	0	0	0	0	0	0	0	0	0	0	0	0	0	0		批量查询
玛卡西童装 睡衣	0	0	0	0	0	0	0	0	0	0	0	0	0	0	0		批量查询
玛卡西童装t	0	0	0	0	0	0	0	0	0	0	0	0	0	0	0		批量查询
玛卡西童装2013新款	0	0	0	0	0	0	0	0	0	0	0	0	0	0	0		批量查询
玛卡西童装夏装	0	0	0	0	0	0	0	0	0	0	0	0	0	0	0		批量查询
玛卡磨成粉怎么吃	0	0	0	0	0	0	0	0	0	0	0	0	0	0	0		批量查询
玛卡粉的功效与作用	0	0	0	0	0	0	0	0	0	0	0	0	0	0	0		批量查询
玛卡粉的功效	0	0	0	0	0	0	0	0	0	0	0	0	0	0	0		批量查询
玛卡精片 延时	0	0	0	0	0	0	0	0	0	0	0	0	0	0	0		批量查询
玛卡粉的价格	0	0	0	0	0	0	0	0	0	0	0	0	0	0	0		批量查询
玛卡精片男人保健品	0	0	0	0	0	0	0	0	0	0	0	0	0	0	0		批量查询
中药玛卡的作用	0	0	0	0	0	0	0	0	0	0	0	0	0	0	0		批量查询
玛卡精片食用方法	0	0	0	0	0	0	0	0	0	0	0	0	0	0	0		批量查询
玛卡怎么吃功效好	0	0	0	0	0	0	0	0	0	0	0	0	0	0	0		批量查询
什么品牌玛卡的功效好	0	0	0	0	0	0	0	0	0	0	0	0	0	0	0		批量查询
玛卡和什么一起泡酒好	0	0	0	0	0	0	0	0	0	0	0	0	0	0	0		批量查询
玛卡精片女	0	0	0	0	0	0	0	0	0	0	0	0	0	0	0		批量查询
玛卡西尼价格	0	0	0	0	0	0	0	0	0	0	0	0	0	0	0		批量查询
玛卡西尼衬衫 长袖	0	0	0	0	0	0	0	0	0	0	0	0	0	0	0		批量查询
玛卡西尼衬衫代购	0	0	0	0	0	0	0	0	0	0	0	0	0	0	0		批量查询
玛卡西尼衬衫 黑色	0	0	0	0	0	0	0	0	0	0	0	0	0	0	0		批量查询
玛卡西尼衬衫 五分袖	0	0	0	0	0	0	0	0	0	0	0	0	0	0	0		批量查询
玛卡西尼短袖衬衫	0	0	0	0	0	0	0	0	0	0	0	0	0	0	0		批量查询
玛卡西尼 中袖衬衫	0	0	0	0	0	0	0	0	0	0	0	0	0	0	0		批量查询
2014玛卡西尼衬衫	0	0	0	0	0	0	0	0	0	0	0	0	0	0	0		批量查询
玛卡西尼男短袖衬衫	0	0	0	0	0	0	0	0	0	0	0	0	0	0	0		批量查询
玛卡泡酒的禁忌	0	0	0	0	0	0	0	0	0	0	0	0	0	0	0		批量查询
玛卡禁忌	0	0	0	0	0	0	0	0	0	0	0	0	0	0	0		批量查询
玛卡西尼短袖t恤	0	0	0	0	0	0	0	0	0	0	0	0	0	0	0		批量查询
玛卡西尼短袖 男	0	0	0	0	0	0	0	0	0	0	0	0	0	0	0		批量查询
玛卡西尼短袖衬	0	0	0	0	0	0	0	0	0	0	0	0	0	0	0		批量查询
玛卡西尼短袖t恤衫	0	0	0	0	0	0	0	0	0	0	0	0	0	0	0		批量查询
玛卡西尼2014短袖	0	0	0	0	0	0	0	0	0	0	0	0	0	0	0		批量查询
代购玛卡西尼 短袖	0	0	0	0	0	0	0	0	0	0	0	0	0	0	0		批量查询
玛卡西尼2013短袖	0	0	0	0	0	0	0	0	0	0	0	0	0	0	0		批量查询
男短袖t恤 玛卡西尼	0	0	0	0	0	0	0	0	0	0	0	0	0	0	0		批量查询
玛卡西尼2014夏	0	0	0	0	0	0	0	0	0	0	0	0	0	0	0		批量查询
玛卡西尼2014裤子	0	0	0	0	0	0	0	0	0	0	0	0	0	0	0		批量查询
玛卡西尼2014春款	0	0	0	0	0	0	0	0	0	0	0	0	0	0	0		批量查询
玛卡西尼2014新款	0	0	0	0	0	0	0	0	0	0	0	0	0	0	0		批量查询
玛卡西尼2014夏 代购	0	0	0	0	0	0	0	0	0	0	0	0	0	0	0		批量查询
玛卡西尼2014休闲裤	0	0	0	0	0	0	0	0	0	0	0	0	0	0	0		批量查询
玛卡西尼2014牛仔裤	0	0	0	0	0	0	0	0	0	0	0	0	0	0	0		批量查询
新鲜玛卡怎么泡酒	0	0	0	0	0	0	0	0	0	0	0	0	0	0	0		批量查询
新鲜玛卡怎么食用	0	0	0	0	0	0	0	0	0	0	0	0	0	0	0		批量查询
云南玛卡 泡酒	0	0	0	0	0	0	0	0	0	0	0	0	0	0	0		批量查询
牛玛卡茶的功效与作用	0	0	0	0	0	0	0	0	0	0	0	0	0	0	0		批量查询
玛卡西尼裤子 休闲裤	0	0	0	0	0	0	0	0	0	0	0	0	0	0	0		批量查询
玛卡西尼裤子牛仔裤	0	0	0	0	0	0	0	0	0	0	0	0	0	0	0		批量查询
玛卡西尼 裤子 2013	0	0	0	0	0	0	0	0	0	0	0	0	0	0	0		批量查询
黑玛卡的功效	0	0	0	0	0	0	0	0	0	0	0	0	0	0	0		批量查询
玛卡西尼休闲西服	0	0	0	0	0	0	0	0	0	0	0	0	0	0	0		批量查询
玛卡西尼 单西西服	0	0	0	0	0	0	0	0	0	0	0	0	0	0	0		批量查询
玛卡西尼2014春 西服	0	0	0	0	0	0	0	0	0	0	0	0	0	0	0		批量查询
玛卡西尼 男 西服	0	0	0	0	0	0	0	0	0	0	0	0	0	0	0		批量查询
玛卡泡酒功效	0	0	0	0	0	0	0	0	0	0	0	0	0	0	0		批量查询
玛卡泡酒的功效怎么样	0	0	0	0	0	0	0	0	0	0	0	0	0	0	0		批量查询
玛卡泡酒的作用	0	0	0	0	0	0	0	0	0	0	0	0	0	0	0		批量查询
玛卡泡酒功效如何	0	0	0	0	0	0	0	0	0	0	0	0	0	0	0		批量查询
玛卡泡酒 什么功效	0	0	0	0	0	0	0	0	0	0	0	0	0	0	0		批量查询
玛卡西尼夹克男	0	0	0	0	0	0	0	0	0	0	0	0	0	0	0		批量查询
玛卡西尼皮夹克	0	0	0	0	0	0	0	0	0	0	0	0	0	0	0		批量查询
玛卡西尼长袖t恤	0	0	0	0	0	0	0	0	0	0	0	0	0	0	0		批量查询
玛卡西尼正品t恤	0	0	0	0	0	0	0	0	0	0	0	0	0	0	0		批量查询
玛卡西尼 t恤 2014	0	0	0	0	0	0	0	0	0	0	0	0	0	0	0		批量查询
玛卡西尼男款t恤	0	0	0	0	0	0	0	0	0	0	0	0	0	0	0		批量查询
玛卡煲汤的做法	0	0	0	0	0	0	0	0	0	0	0	0	0	0	0		批量查询
玛卡怎么煲汤	0	0	0	0	0	0	0	0	0	0	0	0	0	0	0		批量查询
天然玛卡怎么煲汤	0	0	0	0	0	0	0	0	0	0	0	0	0	0	0		批量查询
玛卡怎煲汤	0	0	0	0	0	0	0	0	0	0	0	0	0	0	0		批量查询
玛卡胶囊的作用	0	0	0	0	0	0	0	0	0	0	0	0	0	0	0		批量查询
会泽玛卡种植技术	0	0	0	0	0	0	0	0	0	0	0	0	0	0	0		批量查询
玛卡育苗种植技术	0	0	0	0	0	0	0	0	0	0	0	0	0	0	0		批量查询
玛卡种植栽培技术下载	0	0	0	0	0	0	0	0	0	0	0	0	0	0	0		批量查询
玛卡真假鉴别	0	0	0	0	0	0	0	0	0	0	0	0	0	0	0		批量查询
玛卡的种植方法	0	0	0	0	0	0	0	0	0	0	0	0	0	0	0		批量查询
云南种植玛卡的基地	0	0	0	0	0	0	0	0	0	0	0	0	0	0	0		批量查询
松古树美玛卡片	0	0	0	0	0	0	0	0	0	0	0	0	0	0	0		批量查询
玛卡种植的海拔高度	0	0	0	0	0	0	0	0	0	0	0	0	0	0	0		批量查询
种植玛卡最低海拔	0	0	0	0	0	0	0	0	0	0	0	0	0	0	0		批量查询
玛卡种植合作社	0	0	0	0	0	0	0	0	0	0	0	0	0	0	0		批量查询
丽江玛卡种植基地	0	0	0	0	0	0	0	0	0	0	0	0	0	0	0		批量查询
丽江哪里种植玛卡	0	0	0	0	0	0	0	0	0	0	0	0	0	0	0		批量查询
如何种植丽江玛卡	0	0	0	0	0	0	0	0	0	0	0	0	0	0	0		批量查询
丽江玛卡基地	0	0	0	0	0	0	0	0	0	0	0	0	0	0	0		批量查询
玛卡不适合什么人吃	0	0	0	0	0	0	0	0	0	0	0	0	0	0	0		批量查询
中药玛卡如何食用	0	0	0	0	0	0	0	0	0	0	0	0	0	0	0		批量查询
玛卡精片 保健品	0	0	0	0	0	0	0	0	0	0	0	0	0	0	0		批量查询
服用玛卡有害身体吗	0	0	0	0	0	0	0	0	0	0	0	0	0	0	0		批量查询
野口玛卡营养胶囊怎样	0	0	0	0	0	0	0	0	0	0	0	0	0	0	0		批量查询
玛卡精片女士用	0	0	0	0	0	0	0	0	0	0	0	0	0	0	0		批量查询
玛卡是否真有用	0	0	0	0	0	0	0	0	0	0	0	0	0	0	0		批量查询
吃了玛卡真的有效吗	0	0	0	0	0	0	0	0	0	0	0	0	0	0	0		批量查询
丽江玛卡真的有用	0	0	0	0	0	0	0	0	0	0	0	0	0	0	0		批量查询
玛卡精片男性	0	0	0	0	0	0	0	0	0	0	0	0	0	0	0		批量查询
干玛卡的价格	0	0	0	0	0	0	0	0	0	0	0	0	0	0	0		批量查询
倍力阳光玛卡	0	0	0	0	0	0	0	0	0	0	0	0	0	0	0		批量查询
女童装玛米玛卡夏装	0	0	0	0	0	0	0	0	0	0	0	0	0	0	0		批量查询
玛米玛卡女 童装春装	0	0	0	0	0	0	0	0	0	0	0	0	0	0	0		批量查询
2014童装女玛米玛卡	0	0	0	0	0	0	0	0	0	0	0	0	0	0	0		批量查询
中药玛卡的吃法	0	0	0	0	0	0	0	0	0	0	0	0	0	0	0		批量查询
玛卡的吃法和疗效	0	0	0	0	0	0	0	0	0	0	0	0	0	0	0		批量查询
鲜玛卡的吃法	0	0	0	0	0	0	0	0	0	0	0	0	0	0	0		批量查询
玛米玛卡童装男短袖	0	0	0	0	0	0	0	0	0	0	0	0	0	0	0		批量查询
玛米玛卡男童装t恤	0	0	0	0	0	0	0	0	0	0	0	0	0	0	0		批量查询
玛米玛卡男童装春装	0	0	0	0	0	0	0	0	0	0	0	0	0	0	0		批量查询
伽玛卡兹鱼钩 爆炸钩	0	0	0	0	0	0	0	0	0	0	0	0	0	0	0		批量查询
日本伽玛卡兹爆炸钩	0	0	0	0	0	0	0	0	0	0	0	0	0	0	0		批量查询
伽玛卡兹伽爆炸钩	0	0	0	0	0	0	0	0	0	0	0	0	0	0	0		批量查询
种植玛卡需要什么条件	0	0	0	0	0	0	0	0	0	0	0	0	0	0	0		批量查询
玛卡在多少度种植条件	0	0	0	0	0	0	0	0	0	0	0	0	0	0	0		批量查询
伽玛卡兹矶钓竿黑斩	0	0	0	0	0	0	0	0	0	0	0	0	0	0	0		批量查询
伽玛卡兹 矶钓竿 alma	0	0	0	0	0	0	0	0	0	0	0	0	0	0	0		批量查询
伽玛卡兹 矶钓竿 rxr	0	0	0	0	0	0	0	0	0	0	0	0	0	0	0		批量查询
伽玛卡兹新款 矶钓竿	0	0	0	0	0	0	0	0	0	0	0	0	0	0	0		批量查询
伽玛卡兹 矶钓竿 sentio	0	0	0	0	0	0	0	0	0	0	0	0	0	0	0		批量查询
伽玛卡兹 矶钓竿 尾长	0	0	0	0	0	0	0	0	0	0	0	0	0	0	0		批量查询
伽玛卡兹 矶钓竿一刻	0	0	0	0	0	0	0	0	0	0	0	0	0	0	0		批量查询
香格里拉玛卡种植基地	0	0	0	0	0	0	0	0	0	0	0	0	0	0	0		批量查询
伽玛卡兹鱼钩 进口黑	0	0	0	0	0	0	0	0	0	0	0	0	0	0	0		批量查询
伽玛卡兹鱼钩 进口白	0	0	0	0	0	0	0	0	0	0	0	0	0	0	0		批量查询
进口伽玛卡兹tko鱼钩	0	0	0	0	0	0	0	0	0	0	0	0	0	0	0		批量查询
玛卡栽培技术	0	0	0	0	0	0	0	0	0	0	0	0	0	0	0		批量查询
玛卡栽培视频	0	0	0	0	0	0	0	0	0	0	0	0	0	0	0		批量查询
玛卡栽培	0	0	0	0	0	0	0	0	0	0	0	0	0	0	0		批量查询
玛卡引种及栽培技术	0	0	0	0	0	0	0	0	0	0	0	0	0	0	0		批量查询
丽江玛卡栽培技术	0	0	0	0	0	0	0	0	0	0	0	0	0	0	0		批量查询
伽玛卡兹凌波6.3	0	0	0	0	0	0	0	0	0	0	0	0	0	0	0		批量查询
伽玛卡兹凌波6.3米	0	0	0	0	0	0	0	0	0	0	0	0	0	0	0		批量查询
伽玛卡兹凌波5.3	0	0	0	0	0	0	0	0	0	0	0	0	0	0	0		批量查询
伽玛卡兹凌波7.3米	0	0	0	0	0	0	0	0	0	0	0	0	0	0	0		批量查询
伽玛卡兹 凌波硬调	0	0	0	0	0	0	0	0	0	0	0	0	0	0	0		批量查询
伽玛卡兹 gamakatsu 凌波	0	0	0	0	0	0	0	0	0	0	0	0	0	0	0		批量查询
绿荫塘玛卡种植基地	0	0	0	0	0	0	0	0	0	0	0	0	0	0	0		批量查询
东川种植玛卡的基地	0	0	0	0	0	0	0	0	0	0	0	0	0	0	0		批量查询
中国玛卡种植第一人	0	0	0	0	0	0	0	0	0	0	0	0	0	0	0		批量查询
伽玛卡兹伽玛鲤4.5米	0	0	0	0	0	0	0	0	0	0	0	0	0	0	0		批量查询
伽玛卡兹 伽玛鲤x	0	0	0	0	0	0	0	0	0	0	0	0	0	0	0		批量查询
伽玛卡兹 伽玛鲤四代	0	0	0	0	0	0	0	0	0	0	0	0	0	0	0		批量查询
伽玛卡兹 伽玛鲤3代	0	0	0	0	0	0	0	0	0	0	0	0	0	0	0		批量查询
伽玛卡兹-伽玛鲤	0	0	0	0	0	0	0	0	0	0	0	0	0	0	0		批量查询
伽玛卡兹 伽玛鲤x 18	0	0	0	0	0	0	0	0	0	0	0	0	0	0	0		批量查询
伽玛卡兹新款伽玛鲤	0	0	0	0	0	0	0	0	0	0	0	0	0	0	0		批量查询
玛卡药店有卖吗	0	0	0	0	0	0	0	0	0	0	0	0	0	0	0		批量查询
玛卡在正规药店有卖吗	0	0	0	0	0	0	0	0	0	0	0	0	0	0	0		批量查询
正规药店有玛卡卖吗	0	0	0	0	0	0	0	0	0	0	0	0	0	0	0		批量查询
洛阳什么药店有卖玛卡	0	0	0	0	0	0	0	0	0	0	0	0	0	0	0		批量查询
玛卡郑州哪个药店有卖	0	0	0	0	0	0	0	0	0	0	0	0	0	0	0		批量查询
正规药店卖玛卡吗	0	0	0	0	0	0	0	0	0	0	0	0	0	0	0		批量查询
会泽大海草山玛卡	0	0	0	0	0	0	0	0	0	0	0	0	0	0	0		批量查询
玛卡果作用	0	0	0	0	0	0	0	0	0	0	0	0	0	0	0		批量查询
安国药材市场玛卡价格	0	0	0	0	0	0	0	0	0	0	0	0	0	0	0		批量查询
昆明药材市场玛卡	0	0	0	0	0	0	0	0	0	0	0	0	0	0	0		批量查询
玛卡药材价格	0	0	0	0	0	0	0	0	0	0	0	0	0	0	0		批量查询
药材 玛卡 价格走势	0	0	0	0	0	0	0	0	0	0	0	0	0	0	0		批量查询
玛卡在中国的市场	0	0	0	0	0	0	0	0	0	0	0	0	0	0	0		批量查询
药材玛卡哪里有卖的	0	0	0	0	0	0	0	0	0	0	0	0	0	0	0		批量查询
玛卡片 玛咖片	0	0	0	0	0	0	0	0	0	0	0	0	0	0	0		批量查询
玛卡果功效	0	0	0	0	0	0	0	0	0	0	0	0	0	0	0		批量查询
拉摩力拉玛卡片是假药	0	0	0	0	0	0	0	0	0	0	0	0	0	0	0		批量查询
拉摩力拉玛卡片真假	0	0	0	0	0	0	0	0	0	0	0	0	0	0	0		批量查询
拉摩力拉玛卡片副作用	0	0	0	0	0	0	0	0	0	0	0	0	0	0	0		批量查询
拉摩力拉玛卡片可信吗	0	0	0	0	0	0	0	0	0	0	0	0	0	0	0		批量查询
拉摩力拉玛卡片有用吗	0	0	0	0	0	0	0	0	0	0	0	0	0	0	0		批量查询
拉摩力拉玛卡精片60片	0	0	0	0	0	0	0	0	0	0	0	0	0	0	0		批量查询
玛卡玛卡	0	0	0	0	0	0	0	0	0	0	0	0	0	0	0		批量查询
西藏玛卡有没有副作用	0	0	0	0	0	0	0	0	0	0	0	0	0	0	0		批量查询
玛卡干果有没有副作用	0	0	0	0	0	0	0	0	0	0	0	0	0	0	0		批量查询
玛米玛卡男童棉服	0	0	0	0	0	0	0	0	0	0	0	0	0	0	0		批量查询
代购玛卡	0	0	0	0	0	0	0	0	0	0	0	0	0	0	0		批量查询
玛卡可以泡酒吗	0	0	0	0	0	0	0	0	0	0	0	0	0	0	0		批量查询
玛卡泡酒料	0	0	0	0	0	0	0	0	0	0	0	0	0	0	0		批量查询
补肾玛卡泡酒料	0	0	0	0	0	0	0	0	0	0	0	0	0	0	0		批量查询
玛卡鲜果泡酒	0	0	0	0	0	0	0	0	0	0	0	0	0	0	0		批量查询
泡酒料中药 玛卡	0	0	0	0	0	0	0	0	0	0	0	0	0	0	0		批量查询
泡酒料 黑玛卡	0	0	0	0	0	0	0	0	0	0	0	0	0	0	0		批量查询
秘鲁拉魔力拉玛卡	0	0	0	0	0	0	0	0	0	0	0	0	0	0	0		批量查询
秘鲁拉魔力拉玛卡片	0	0	0	0	0	0	0	0	0	0	0	0	0	0	0		批量查询
玛卡粉 云南	0	0	0	0	0	0	0	0	0	0	0	0	0	0	0		批量查询
如何辨别玛卡	0	0	0	0	0	0	0	0	0	0	0	0	0	0	0		批量查询
伽玛卡兹鱼竿使用报告	0	0	0	0	0	0	0	0	0	0	0	0	0	0	0		批量查询
伽玛卡兹鱼竿价位	0	0	0	0	0	0	0	0	0	0	0	0	0	0	0		批量查询
伽玛卡兹鱼竿怎么样	0	0	0	0	0	0	0	0	0	0	0	0	0	0	0		批量查询
伽玛卡兹鱼竿幻壮天	0	0	0	0	0	0	0	0	0	0	0	0	0	0	0		批量查询
伽玛卡兹云潇天鱼竿	0	0	0	0	0	0	0	0	0	0	0	0	0	0	0		批量查询
伽玛卡兹鱼钩怎么样	0	0	0	0	0	0	0	0	0	0	0	0	0	0	0		批量查询
伽玛卡兹伊势尼鱼钩	0	0	0	0	0	0	0	0	0	0	0	0	0	0	0		批量查询
伽玛卡兹中国总代理	0	0	0	0	0	0	0	0	0	0	0	0	0	0	0		批量查询
中药玛卡粉	0	0	0	0	0	0	0	0	0	0	0	0	0	0	0		批量查询
中药玛卡片	0	0	0	0	0	0	0	0	0	0	0	0	0	0	0		批量查询
中药材玛卡	0	0	0	0	0	0	0	0	0	0	0	0	0	0	0		批量查询
玛卡中药材干果	0	0	0	0	0	0	0	0	0	0	0	0	0	0	0		批量查询
玛卡中药补肾	0	0	0	0	0	0	0	0	0	0	0	0	0	0	0		批量查询
中药材 玛卡果	0	0	0	0	0	0	0	0	0	0	0	0	0	0	0		批量查询
野口玛卡	0	0	0	0	0	0	0	0	0	0	0	0	0	0	0		批量查询
玛米玛卡童装牛仔外套	0	0	0	0	0	0	0	0	0	0	0	0	0	0	0		批量查询
中药玛卡味道	0	0	0	0	0	0	0	0	0	0	0	0	0	0	0		批量查询
玛卡1200目超微粉	0	0	0	0	0	0	0	0	0	0	0	0	0	0	0		批量查询
幼儿舞蹈音乐玛卡丽娜	0	0	0	0	0	0	0	0	0	0	0	0	0	0	0		批量查询
玛卡莱娜舞蹈	0	0	0	0	0	0	0	0	0	0	0	0	0	0	0		批量查询
玛卡丽娜舞蹈	0	0	0	0	0	0	0	0	0	0	0	0	0	0	0		批量查询
秘鲁玛卡中国总代理	0	0	0	0	0	0	0	0	0	0	0	0	0	0	0		批量查询
秘鲁玛卡中国总代理商	0	0	0	0	0	0	0	0	0	0	0	0	0	0	0		批量查询
秘鲁玛卡中国代理	0	0	0	0	0	0	0	0	0	0	0	0	0	0	0		批量查询
秘鲁玛卡中国总代	0	0	0	0	0	0	0	0	0	0	0	0	0	0	0		批量查询
玛卡粉 秘鲁 正品	0	0	0	0	0	0	0	0	0	0	0	0	0	0	0		批量查询
玛卡粉 原装进口	0	0	0	0	0	0	0	0	0	0	0	0	0	0	0		批量查询
玛卡 makayk	0	0	0	0	0	0	0	0	0	0	0	0	0	0	0		批量查询
玛卡粉 正品	0	0	0	0	0	0	0	0	0	0	0	0	0	0	0		批量查询
丽江 正品 玛卡片 干果	0	0	0	0	0	0	0	0	0	0	0	0	0	0	0		批量查询
玛卡生长环境	0	0	0	0	0	0	0	0	0	0	0	0	0	0	0		批量查询
北京康博商城秘鲁玛卡	0	0	0	0	0	0	0	0	0	0	0	0	0	0	0		批量查询
康博商城秘鲁玛卡	0	0	0	0	0	0	0	0	0	0	0	0	0	0	0		批量查询
秘鲁玛卡康博	0	0	0	0	0	0	0	0	0	0	0	0	0	0	0		批量查询
康博商城玛卡多少钱	0	0	0	0	0	0	0	0	0	0	0	0	0	0	0		批量查询
康博商城玛卡官网	0	0	0	0	0	0	0	0	0	0	0	0	0	0	0		批量查询
玛卡正品康博商城	0	0	0	0	0	0	0	0	0	0	0	0	0	0	0		批量查询
康博玛卡	0	0	0	0	0	0	0	0	0	0	0	0	0	0	0		批量查询
元素玛卡片 正品 男性	0	0	0	0	0	0	0	0	0	0	0	0	0	0	0		批量查询
玛卡西尼2013冬款新款	0	0	0	0	0	0	0	0	0	0	0	0	0	0	0		批量查询
玛卡西尼新款衬衫	0	0	0	0	0	0	0	0	0	0	0	0	0	0	0		批量查询
新鲜玛卡泡酒	0	0	0	0	0	0	0	0	0	0	0	0	0	0	0		批量查询
玛卡西尼夹克1099	0	0	0	0	0	0	0	0	0	0	0	0	0	0	0		批量查询
玛卡多咖啡	0	0	0	0	0	0	0	0	0	0	0	0	0	0	0		批量查询
松古树美男士黑玛卡	0	0	0	0	0	0	0	0	0	0	0	0	0	0	0		批量查询
松古树美牌男性玛卡	0	0	0	0	0	0	0	0	0	0	0	0	0	0	0		批量查询
松古树美玛卡官网	0	0	0	0	0	0	0	0	0	0	0	0	0	0	0		批量查询
松古树美 玛卡80片	0	0	0	0	0	0	0	0	0	0	0	0	0	0	0		批量查询
玛卡松古树美效果好不	0	0	0	0	0	0	0	0	0	0	0	0	0	0	0		批量查询
松古树美玛卡当当网	0	0	0	0	0	0	0	0	0	0	0	0	0	0	0		批量查询
松古树美玛卡阿里巴巴	0	0	0	0	0	0	0	0	0	0	0	0	0	0	0		批量查询
松古树美男性黑玛卡	0	0	0	0	0	0	0	0	0	0	0	0	0	0	0		批量查询
玛卡批发 礼盒	0	0	0	0	0	0	0	0	0	0	0	0	0	0	0		批量查询
玛卡粉500克	0	0	0	0	0	0	0	0	0	0	0	0	0	0	0		批量查询
极卡纯玛卡官方网站	0	0	0	0	0	0	0	0	0	0	0	0	0	0	0		批量查询
极卡纯玛卡极卡纯玛卡	0	0	0	0	0	0	0	0	0	0	0	0	0	0	0		批量查询
极卡纯玛卡好不好	0	0	0	0	0	0	0	0	0	0	0	0	0	0	0		批量查询
云南古之极玛卡好不好	0	0	0	0	0	0	0	0	0	0	0	0	0	0	0		批量查询
玛卡粉胶囊	0	0	0	0	0	0	0	0	0	0	0	0	0	0	0		批量查询
深圳极玛卡	0	0	0	0	0	0	0	0	0	0	0	0	0	0	0		批量查询
云南昆明古之极玛卡	0	0	0	0	0	0	0	0	0	0	0	0	0	0	0		批量查询
玛卡多久能见效	0	0	0	0	0	0	0	0	0	0	0	0	0	0	0		批量查询
玛卡多长时间能见效	0	0	0	0	0	0	0	0	0	0	0	0	0	0	0		批量查询
玛卡最短见效时间	0	0	0	0	0	0	0	0	0	0	0	0	0	0	0		批量查询
玛卡用多少天见效	0	0	0	0	0	0	0	0	0	0	0	0	0	0	0		批量查询
玛卡怎么快速见效	0	0	0	0	0	0	0	0	0	0	0	0	0	0	0		批量查询
玛卡见效	0	0	0	0	0	0	0	0	0	0	0	0	0	0	0		批量查询
玛卡粉 补肾	0	0	0	0	0	0	0	0	0	0	0	0	0	0	0		批量查询
淘宝上的玛卡	0	0	0	0	0	0	0	0	0	0	0	0	0	0	0		批量查询
淘宝上买的玛卡有用吗	0	0	0	0	0	0	0	0	0	0	0	0	0	0	0		批量查询
淘宝卖的玛卡是真的吗	0	0	0	0	0	0	0	0	0	0	0	0	0	0	0		批量查询
玛卡 淘宝	0	0	0	0	0	0	0	0	0	0	0	0	0	0	0		批量查询
黄金玛卡一粒 淘宝	0	0	0	0	0	0	0	0	0	0	0	0	0	0	0		批量查询
淘宝哪家的玛卡好	0	0	0	0	0	0	0	0	0	0	0	0	0	0	0		批量查询
延时玛卡玛咖干片哥	0	0	0	0	0	0	0	0	0	0	0	0	0	0	0		批量查询
优质玛卡干片 玛咖	0	0	0	0	0	0	0	0	0	0	0	0	0	0	0		批量查询
黑玛卡干片丽江玛咖	0	0	0	0	0	0	0	0	0	0	0	0	0	0	0		批量查询
活力玛卡	0	0	0	0	0	0	0	0	0	0	0	0	0	0	0		批量查询
玛卡活力素	0	0	0	0	0	0	0	0	0	0	0	0	0	0	0		批量查询
蔚达玛卡复合胶囊	0	0	0	0	0	0	0	0	0	0	0	0	0	0	0		批量查询
丽彩芳姿丽人女士玛卡	0	0	0	0	0	0	0	0	0	0	0	0	0	0	0		批量查询
丽彩芳姿女士玛卡	0	0	0	0	0	0	0	0	0	0	0	0	0	0	0		批量查询
玛卡丽彩多姿	0	0	0	0	0	0	0	0	0	0	0	0	0	0	0		批量查询
丽彩玛卡	0	0	0	0	0	0	0	0	0	0	0	0	0	0	0		批量查询
台湾黄金玛卡	0	0	0	0	0	0	0	0	0	0	0	0	0	0	0		批量查询
台湾玛卡道高粱酒v3	0	0	0	0	0	0	0	0	0	0	0	0	0	0	0		批量查询
台湾玛卡道	0	0	0	0	0	0	0	0	0	0	0	0	0	0	0		批量查询
吃玛卡有什么副作用	0	0	0	0	0	0	0	0	0	0	0	0	0	0	0		批量查询
玛卡粉 玛咖片	0	0	0	0	0	0	0	0	0	0	0	0	0	0	0		批量查询
那个网站卖玛卡是真的	0	0	0	0	0	0	0	0	0	0	0	0	0	0	0		批量查询
网上卖的玛卡有用吗	0	0	0	0	0	0	0	0	0	0	0	0	0	0	0		批量查询
新疆有卖玛卡的	0	0	0	0	0	0	0	0	0	0	0	0	0	0	0		批量查询
秘鲁玛卡药店卖的有吗	0	0	0	0	0	0	0	0	0	0	0	0	0	0	0		批量查询
秘鲁玛卡哈尔滨有卖吗	0	0	0	0	0	0	0	0	0	0	0	0	0	0	0		批量查询
唐山哪有卖秘鲁玛卡的	0	0	0	0	0	0	0	0	0	0	0	0	0	0	0		批量查询
石家庄哪里卖秘鲁玛卡	0	0	0	0	0	0	0	0	0	0	0	0	0	0	0		批量查询
珠海哪里有卖秘鲁玛卡	0	0	0	0	0	0	0	0	0	0	0	0	0	0	0		批量查询
秘鲁玛卡哪里有卖的	0	0	0	0	0	0	0	0	0	0	0	0	0	0	0		批量查询
东莞哪卖秘鲁玛卡	0	0	0	0	0	0	0	0	0	0	0	0	0	0	0		批量查询
秘鲁玛卡北京哪有	0	0	0	0	0	0	0	0	0	0	0	0	0	0	0		批量查询
秘鲁玛卡北京专卖	0	0	0	0	0	0	0	0	0	0	0	0	0	0	0		批量查询
北京秘鲁玛卡直销店	0	0	0	0	0	0	0	0	0	0	0	0	0	0	0		批量查询
西安哪里卖玛卡	0	0	0	0	0	0	0	0	0	0	0	0	0	0	0		批量查询
西安有卖玛卡种子的吗	0	0	0	0	0	0	0	0	0	0	0	0	0	0	0		批量查询
西安哪里有卖玛卡的	0	0	0	0	0	0	0	0	0	0	0	0	0	0	0		批量查询
秘鲁玛卡西安销售地点	0	0	0	0	0	0	0	0	0	0	0	0	0	0	0		批量查询
西安玛卡销售	0	0	0	0	0	0	0	0	0	0	0	0	0	0	0		批量查询
秘鲁玛卡西安专卖店	0	0	0	0	0	0	0	0	0	0	0	0	0	0	0		批量查询
玛卡西安销售点	0	0	0	0	0	0	0	0	0	0	0	0	0	0	0		批量查询
西安药店网玛卡	0	0	0	0	0	0	0	0	0	0	0	0	0	0	0		批量查询
上海又卖玛卡的吗	0	0	0	0	0	0	0	0	0	0	0	0	0	0	0		批量查询
上海哪里有卖玛卡的	0	0	0	0	0	0	0	0	0	0	0	0	0	0	0		批量查询
沈阳哪卖玛卡果的	0	0	0	0	0	0	0	0	0	0	0	0	0	0	0		批量查询
上海中智玛卡总代理	0	0	0	0	0	0	0	0	0	0	0	0	0	0	0		批量查询
上海中智玛卡官网	0	0	0	0	0	0	0	0	0	0	0	0	0	0	0		批量查询
上海玛卡人生	0	0	0	0	0	0	0	0	0	0	0	0	0	0	0		批量查询
玛卡粉末	0	0	0	0	0	0	0	0	0	0	0	0	0	0	0		批量查询
玛卡在上海哪里买到	0	0	0	0	0	0	0	0	0	0	0	0	0	0	0		批量查询
吉林市有玛卡吗	0	0	0	0	0	0	0	0	0	0	0	0	0	0	0		批量查询
丽江玛卡作用	0	0	0	0	0	0	0	0	0	0	0	0	0	0	0		批量查询
玛米玛卡儿童家具怎样	0	0	0	0	0	0	0	0	0	0	0	0	0	0	0		批量查询
玛米玛卡家具图片	0	0	0	0	0	0	0	0	0	0	0	0	0	0	0		批量查询
玛米玛卡儿童家具	0	0	0	0	0	0	0	0	0	0	0	0	0	0	0		批量查询
那有卖玛卡胶囊	0	0	0	0	0	0	0	0	0	0	0	0	0	0	0		批量查询
任丘那有卖玛卡胶囊	0	0	0	0	0	0	0	0	0	0	0	0	0	0	0		批量查询
北京哪有卖玛卡胶囊	0	0	0	0	0	0	0	0	0	0	0	0	0	0	0		批量查询
玛卡鲜果	0	0	0	0	0	0	0	0	0	0	0	0	0	0	0		批量查询
玛卡药上海哪里有买	0	0	0	0	0	0	0	0	0	0	0	0	0	0	0		批量查询
日本伽玛卡兹矶钓竿	0	0	0	0	0	0	0	0	0	0	0	0	0	0	0		批量查询
伽玛卡兹矶钓竿价格	0	0	0	0	0	0	0	0	0	0	0	0	0	0	0		批量查询
伽玛卡兹矶顶级矶竿	0	0	0	0	0	0	0	0	0	0	0	0	0	0	0		批量查询
诺奥 玛卡	0	0	0	0	0	0	0	0	0	0	0	0	0	0	0		批量查询
伽玛卡兹凌波21尺	0	0	0	0	0	0	0	0	0	0	0	0	0	0	0		批量查询
伽玛卡兹凌波硬调	0	0	0	0	0	0	0	0	0	0	0	0	0	0	0		批量查询
伽玛卡兹凌波硬调53	0	0	0	0	0	0	0	0	0	0	0	0	0	0	0		批量查询
伽玛卡兹 凌波图片	0	0	0	0	0	0	0	0	0	0	0	0	0	0	0		批量查询
maca玛卡 秘鲁玛卡片	0	0	0	0	0	0	0	0	0	0	0	0	0	0	0		批量查询
玛卡片有什么副作用	0	0	0	0	0	0	0	0	0	0	0	0	0	0	0		批量查询
拉摩力拉玛卡有效果吗	0	0	0	0	0	0	0	0	0	0	0	0	0	0	0		批量查询
拉么力拉玛卡真假辩认	0	0	0	0	0	0	0	0	0	0	0	0	0	0	0		批量查询
丽江玛卡种子	0	0	0	0	0	0	0	0	0	0	0	0	0	0	0		批量查询
野生玛卡怎么吃	0	0	0	0	0	0	0	0	0	0	0	0	0	0	0		批量查询
野生玛卡怎么吃最好	0	0	0	0	0	0	0	0	0	0	0	0	0	0	0		批量查询
野生玛卡长什么样子	0	0	0	0	0	0	0	0	0	0	0	0	0	0	0		批量查询
吃玛卡多少天有反应	0	0	0	0	0	0	0	0	0	0	0	0	0	0	0		批量查询
玛卡吃一年	0	0	0	0	0	0	0	0	0	0	0	0	0	0	0		批量查询
美国进口玛卡阴茎增大增长药	0	0	0	0	0	0	0	0	0	0	0	0	0	0	0		批量查询
补肾中药材玛卡	0	0	0	0	0	0	0	0	0	0	0	0	0	0	0		批量查询
天然补肾壮阳玛卡	0	0	0	0	0	0	0	0	0	0	0	0	0	0	0		批量查询
延时喷剂补肾玛卡	0	0	0	0	0	0	0	0	0	0	0	0	0	0	0		批量查询
补肾玛卡片	0	0	0	0	0	0	0	0	0	0	0	0	0	0	0		批量查询
玛咖助勃延时增大补肾玛卡	0	0	0	0	0	0	0	0	0	0	0	0	0	0	0		批量查询
maca进口玛卡	0	0	0	0	0	0	0	0	0	0	0	0	0	0	0		批量查询
玛卡补肾茶	0	0	0	0	0	0	0	0	0	0	0	0	0	0	0		批量查询
玛卡补肾壮阳	0	0	0	0	0	0	0	0	0	0	0	0	0	0	0		批量查询
玛卡补肾阳	0	0	0	0	0	0	0	0	0	0	0	0	0	0	0		批量查询
玛卡补肾药材	0	0	0	0	0	0	0	0	0	0	0	0	0	0	0		批量查询
玛卡补肾片	0	0	0	0	0	0	0	0	0	0	0	0	0	0	0		批量查询
玛卡补肾 丽江	0	0	0	0	0	0	0	0	0	0	0	0	0	0	0		批量查询
玛卡补肾now	0	0	0	0	0	0	0	0	0	0	0	0	0	0	0		批量查询
玛卡咖伟有副作用吗	0	0	0	0	0	0	0	0	0	0	0	0	0	0	0		批量查询
玛卡西尼牌子怎么样	0	0	0	0	0	0	0	0	0	0	0	0	0	0	0		批量查询
新鲜玛卡泡酒比例	0	0	0	0	0	0	0	0	0	0	0	0	0	0	0		批量查询
鲜玛卡泡酒比例是多少	0	0	0	0	0	0	0	0	0	0	0	0	0	0	0		批量查询
干玛卡泡酒比例	0	0	0	0	0	0	0	0	0	0	0	0	0	0	0		批量查询
玛卡粉泡酒比例是多少	0	0	0	0	0	0	0	0	0	0	0	0	0	0	0		批量查询
玛卡枸杞泡酒的比例	0	0	0	0	0	0	0	0	0	0	0	0	0	0	0		批量查询
玛卡泡酒的配料	0	0	0	0	0	0	0	0	0	0	0	0	0	0	0		批量查询
玛卡泡酒的方法	0	0	0	0	0	0	0	0	0	0	0	0	0	0	0		批量查询
玛卡泡酒多长时间	0	0	0	0	0	0	0	0	0	0	0	0	0	0	0		批量查询
用玛卡怎么泡酒	0	0	0	0	0	0	0	0	0	0	0	0	0	0	0		批量查询
玛卡果怎么泡酒	0	0	0	0	0	0	0	0	0	0	0	0	0	0	0		批量查询
新鲜玛卡泡酒怎么吃	0	0	0	0	0	0	0	0	0	0	0	0	0	0	0		批量查询
干玛卡泡酒怎么泡	0	0	0	0	0	0	0	0	0	0	0	0	0	0	0		批量查询
玛卡粉 玛咖精片	0	0	0	0	0	0	0	0	0	0	0	0	0	0	0		批量查询
玛卡片如何服用	0	0	0	0	0	0	0	0	0	0	0	0	0	0	0		批量查询
玛卡片服用方法	0	0	0	0	0	0	0	0	0	0	0	0	0	0	0		批量查询
玛卡批发价	0	0	0	0	0	0	0	0	0	0	0	0	0	0	0		批量查询
秘鲁玛卡 批发	0	0	0	0	0	0	0	0	0	0	0	0	0	0	0		批量查询
丽江黑玛卡批发	0	0	0	0	0	0	0	0	0	0	0	0	0	0	0		批量查询
丽江紫玛卡批发	0	0	0	0	0	0	0	0	0	0	0	0	0	0	0		批量查询
享硬玛卡浓缩片批发	0	0	0	0	0	0	0	0	0	0	0	0	0	0	0		批量查询
玛卡盒子批发	0	0	0	0	0	0	0	0	0	0	0	0	0	0	0		批量查询
玛卡真假的判别	0	0	0	0	0	0	0	0	0	0	0	0	0	0	0		批量查询
秘鲁玛卡真假识别	0	0	0	0	0	0	0	0	0	0	0	0	0	0	0		批量查询
怎样辨别玛卡真假	0	0	0	0	0	0	0	0	0	0	0	0	0	0	0		批量查询
如何判断玛卡真假	0	0	0	0	0	0	0	0	0	0	0	0	0	0	0		批量查询
玛卡真假怎么辨认	0	0	0	0	0	0	0	0	0	0	0	0	0	0	0		批量查询
玛咖和玛卡的区别	0	0	0	0	0	0	0	0	0	0	0	0	0	0	0		批量查询
古之极 玛卡	0	0	0	0	0	0	0	0	0	0	0	0	0	0	0		批量查询
伽玛卡兹 汕头 广州	0	0	0	0	0	0	0	0	0	0	0	0	0	0	0		批量查询
中药玛卡怎样服用	0	0	0	0	0	0	0	0	0	0	0	0	0	0	0		批量查询
玛米玛卡加盟店	0	0	0	0	0	0	0	0	0	0	0	0	0	0	0		批量查询
丽江玛卡片	0	0	0	0	0	0	0	0	0	0	0	0	0	0	0		批量查询
丽江紫玛卡	0	0	0	0	0	0	0	0	0	0	0	0	0	0	0		批量查询
蔚达男式玛卡复合胶囊	0	0	0	0	0	0	0	0	0	0	0	0	0	0	0		批量查询
式玛卡龙	0	0	0	0	0	0	0	0	0	0	0	0	0	0	0		批量查询
式玛卡龙中国有限公司	0	0	0	0	0	0	0	0	0	0	0	0	0	0	0		批量查询
式玛卡龙北京代理	0	0	0	0	0	0	0	0	0	0	0	0	0	0	0		批量查询
式玛卡龙涂料	0	0	0	0	0	0	0	0	0	0	0	0	0	0	0		批量查询
式玛卡龙油漆北京代理	0	0	0	0	0	0	0	0	0	0	0	0	0	0	0		批量查询
1斤玛卡泡酒	0	0	0	0	0	0	0	0	0	0	0	0	0	0	0		批量查询
玛卡是从哪发货呢	0	0	0	0	0	0	0	0	0	0	0	0	0	0	0		批量查询
云南丽江轩庆玛卡	0	0	0	0	0	0	0	0	0	0	0	0	0	0	0		批量查询
玛卡益康片营养知识	0	0	0	0	0	0	0	0	0	0	0	0	0	0	0		批量查询
黑玛卡精片	0	0	0	0	0	0	0	0	0	0	0	0	0	0	0		批量查询
玛卡的营养价值及功效	0	0	0	0	0	0	0	0	0	0	0	0	0	0	0		批量查询
玛卡炖什么最营养	0	0	0	0	0	0	0	0	0	0	0	0	0	0	0		批量查询
玛卡的营养和功效	0	0	0	0	0	0	0	0	0	0	0	0	0	0	0		批量查询
玛卡的营养价值	0	0	0	0	0	0	0	0	0	0	0	0	0	0	0		批量查询
玛卡精片正品	0	0	0	0	0	0	0	0	0	0	0	0	0	0	0		批量查询
紫玛卡和黄玛卡的区别	0	0	0	0	0	0	0	0	0	0	0	0	0	0	0		批量查询
新鲜玛卡可以炖什么吃	0	0	0	0	0	0	0	0	0	0	0	0	0	0	0		批量查询
丽江玛卡如何吃	0	0	0	0	0	0	0	0	0	0	0	0	0	0	0		批量查询
什么人不能吃玛卡	0	0	0	0	0	0	0	0	0	0	0	0	0	0	0		批量查询
云南丽江玛卡片	0	0	0	0	0	0	0	0	0	0	0	0	0	0	0		批量查询
玛卡片丽江购买的药店	0	0	0	0	0	0	0	0	0	0	0	0	0	0	0		批量查询
丽江产 玛卡片	0	0	0	0	0	0	0	0	0	0	0	0	0	0	0		批量查询
真假云南丽江玛卡片	0	0	0	0	0	0	0	0	0	0	0	0	0	0	0		批量查询
云南玛卡片如何食用	0	0	0	0	0	0	0	0	0	0	0	0	0	0	0		批量查询
玛卡新鲜果500包邮	0	0	0	0	0	0	0	0	0	0	0	0	0	0	0		批量查询
玛卡精片oem	0	0	0	0	0	0	0	0	0	0	0	0	0	0	0		批量查询
武汉三和生物工程有限公司玛卡桂林销售部	0	0	0	0	0	0	0	0	0	0	0	0	0	0	0		批量查询
玛卡的功效和副作用	0	0	0	0	0	0	0	0	0	0	0	0	0	0	0		批量查询
vitacost 玛卡maca	0	0	0	0	0	0	0	0	0	0	0	0	0	0	0		批量查询
黄金玛卡15粒	0	0	0	0	0	0	0	0	0	0	0	0	0	0	0		批量查询
黄金玛卡 延时	0	0	0	0	0	0	0	0	0	0	0	0	0	0	0		批量查询
壮阳延时黄金玛卡	0	0	0	0	0	0	0	0	0	0	0	0	0	0	0		批量查询
正品美国黄金玛卡	0	0	0	0	0	0	0	0	0	0	0	0	0	0	0		批量查询
正品美国轲臣蓝色引擎红金黄金玛卡	0	0	0	0	0	0	0	0	0	0	0	0	0	0	0		批量查询
益康玛卡咀嚼片	0	0	0	0	0	0	0	0	0	0	0	0	0	0	0		批量查询
逆时针玛卡咖啡	0	0	0	0	0	0	0	0	0	0	0	0	0	0	0		批量查询
玛卡咖啡代工	0	0	0	0	0	0	0	0	0	0	0	0	0	0	0		批量查询
玛卡可以增大吗	0	0	0	0	0	0	0	0	0	0	0	0	0	0	0		批量查询
黄金玛卡15粒装	0	0	0	0	0	0	0	0	0	0	0	0	0	0	0		批量查询
黄金玛卡男用正品	0	0	0	0	0	0	0	0	0	0	0	0	0	0	0		批量查询
玛卡精片加工	0	0	0	0	0	0	0	0	0	0	0	0	0	0	0		批量查询
黄金玛卡干片	0	0	0	0	0	0	0	0	0	0	0	0	0	0	0		批量查询
黄金玛卡秘鲁正品	0	0	0	0	0	0	0	0	0	0	0	0	0	0	0		批量查询
玛卡咖啡男用	0	0	0	0	0	0	0	0	0	0	0	0	0	0	0		批量查询
玛卡咖啡 秘鲁 正品	0	0	0	0	0	0	0	0	0	0	0	0	0	0	0		批量查询
玛卡咖啡正品	0	0	0	0	0	0	0	0	0	0	0	0	0	0	0		批量查询
玛卡咖啡补肾	0	0	0	0	0	0	0	0	0	0	0	0	0	0	0		批量查询
玛卡咖啡男人	0	0	0	0	0	0	0	0	0	0	0	0	0	0	0		批量查询
皇朝玛卡咖啡	0	0	0	0	0	0	0	0	0	0	0	0	0	0	0		批量查询
马来西亚玛卡咖啡	0	0	0	0	0	0	0	0	0	0	0	0	0	0	0		批量查询
maca 玛卡咖啡	0	0	0	0	0	0	0	0	0	0	0	0	0	0	0		批量查询
秘鲁玛卡咖啡	0	0	0	0	0	0	0	0	0	0	0	0	0	0	0		批量查询
女人吃玛卡有什么功效	0	0	0	0	0	0	0	0	0	0	0	0	0	0	0		批量查询
云南玛卡精片	0	0	0	0	0	0	0	0	0	0	0	0	0	0	0		批量查询
诺奥玛卡胶囊	0	0	0	0	0	0	0	0	0	0	0	0	0	0	0		批量查询
玛卡的作用和食用方法	0	0	0	0	0	0	0	0	0	0	0	0	0	0	0		批量查询
紫玛卡鲜果秘鲁 丽江	0	0	0	0	0	0	0	0	0	0	0	0	0	0	0		批量查询
玛卡鲜果 紫玛咖	0	0	0	0	0	0	0	0	0	0	0	0	0	0	0		批量查询
云南紫玛卡鲜果	0	0	0	0	0	0	0	0	0	0	0	0	0	0	0		批量查询
新鲜玛卡紫 玛咖鲜果	0	0	0	0	0	0	0	0	0	0	0	0	0	0	0		批量查询
玛卡果多少钱一斤	0	0	0	0	0	0	0	0	0	0	0	0	0	0	0		批量查询
云南丽江紫玛卡干果	0	0	0	0	0	0	0	0	0	0	0	0	0	0	0		批量查询
百安堂日本黑玛卡	0	0	0	0	0	0	0	0	0	0	0	0	0	0	0		批量查询
丽江玛卡多少钱一公斤	0	0	0	0	0	0	0	0	0	0	0	0	0	0	0		批量查询
野象玛卡	0	0	0	0	0	0	0	0	0	0	0	0	0	0	0		批量查询
丽江黑新鲜玛卡鲜果	0	0	0	0	0	0	0	0	0	0	0	0	0	0	0		批量查询
进口野生黑玛卡干果	0	0	0	0	0	0	0	0	0	0	0	0	0	0	0		批量查询
进口黑玛卡干果	0	0	0	0	0	0	0	0	0	0	0	0	0	0	0		批量查询
原装进口玛卡干果	0	0	0	0	0	0	0	0	0	0	0	0	0	0	0		批量查询
丽江玛卡精片	0	0	0	0	0	0	0	0	0	0	0	0	0	0	0		批量查询
玛卡胶囊有用吗	0	0	0	0	0	0	0	0	0	0	0	0	0	0	0		批量查询
玛卡含片价格	0	0	0	0	0	0	0	0	0	0	0	0	0	0	0		批量查询
昆明玛卡种子	0	0	0	0	0	0	0	0	0	0	0	0	0	0	0		批量查询
适合小高山玛卡种子	0	0	0	0	0	0	0	0	0	0	0	0	0	0	0		批量查询
黄玛卡种子	0	0	0	0	0	0	0	0	0	0	0	0	0	0	0		批量查询
云南丽江玛卡种子	0	0	0	0	0	0	0	0	0	0	0	0	0	0	0		批量查询
玛咖精片丽江玛卡	0	0	0	0	0	0	0	0	0	0	0	0	0	0	0		批量查询
玛卡种子 正品	0	0	0	0	0	0	0	0	0	0	0	0	0	0	0		批量查询
玛卡种子 免运费	0	0	0	0	0	0	0	0	0	0	0	0	0	0	0		批量查询
玛卡种子 正品包邮	0	0	0	0	0	0	0	0	0	0	0	0	0	0	0		批量查询
玛卡种子 包邮	0	0	0	0	0	0	0	0	0	0	0	0	0	0	0		批量查询
玛卡种子干果	0	0	0	0	0	0	0	0	0	0	0	0	0	0	0		批量查询
黑玛卡种子	0	0	0	0	0	0	0	0	0	0	0	0	0	0	0		批量查询
秘鲁玛卡大量代购	0	0	0	0	0	0	0	0	0	0	0	0	0	0	0		批量查询
玛卡 大枣 枸杞泡酒	0	0	0	0	0	0	0	0	0	0	0	0	0	0	0		批量查询
玛卡和枸杞泡酒吗	0	0	0	0	0	0	0	0	0	0	0	0	0	0	0		批量查询
玛卡枸杞泡酒可以么	0	0	0	0	0	0	0	0	0	0	0	0	0	0	0		批量查询
枸杞黑松露玛卡泡酒	0	0	0	0	0	0	0	0	0	0	0	0	0	0	0		批量查询
玛卡枸杞泡酒	0	0	0	0	0	0	0	0	0	0	0	0	0	0	0		批量查询
枸杞与玛卡可以泡酒不	0	0	0	0	0	0	0	0	0	0	0	0	0	0	0		批量查询
西藏玛卡干果	0	0	0	0	0	0	0	0	0	0	0	0	0	0	0		批量查询
西藏玛卡粉	0	0	0	0	0	0	0	0	0	0	0	0	0	0	0		批量查询
西藏野生玛卡干果	0	0	0	0	0	0	0	0	0	0	0	0	0	0	0		批量查询
玛卡干片 西藏	0	0	0	0	0	0	0	0	0	0	0	0	0	0	0		批量查询
西藏 林芝 玛卡	0	0	0	0	0	0	0	0	0	0	0	0	0	0	0		批量查询
西藏紫玛卡	0	0	0	0	0	0	0	0	0	0	0	0	0	0	0		批量查询
西藏野生玛卡	0	0	0	0	0	0	0	0	0	0	0	0	0	0	0		批量查询
玛卡西藏正品	0	0	0	0	0	0	0	0	0	0	0	0	0	0	0		批量查询
云南玛卡庄园农业科技有限公司	0	0	0	0	0	0	0	0	0	0	0	0	0	0	0		批量查询
玛卡精片代加工	0	0	0	0	0	0	0	0	0	0	0	0	0	0	0		批量查询
云南玛卡酒	0	0	0	0	0	0	0	0	0	0	0	0	0	0	0		批量查询
正品黄金玛卡胶囊秘鲁玛咖maca	0	0	0	0	0	0	0	0	0	0	0	0	0	0	0		批量查询
玛卡泡酒和什么一起泡	0	0	0	0	0	0	0	0	0	0	0	0	0	0	0		批量查询
玛卡泡酒要泡多久	0	0	0	0	0	0	0	0	0	0	0	0	0	0	0		批量查询
正品玛卡maca 延时	0	0	0	0	0	0	0	0	0	0	0	0	0	0	0		批量查询
正品玛卡代购保健品	0	0	0	0	0	0	0	0	0	0	0	0	0	0	0		批量查询
正品玛卡maca	0	0	0	0	0	0	0	0	0	0	0	0	0	0	0		批量查询
正品玛卡男用延时	0	0	0	0	0	0	0	0	0	0	0	0	0	0	0		批量查询
正品黄金玛卡maca	0	0	0	0	0	0	0	0	0	0	0	0	0	0	0		批量查询
正品黄金玛卡15粒	0	0	0	0	0	0	0	0	0	0	0	0	0	0	0		批量查询
黄金玛卡精片正品	0	0	0	0	0	0	0	0	0	0	0	0	0	0	0		批量查询
正品补肾黄金玛卡	0	0	0	0	0	0	0	0	0	0	0	0	0	0	0		批量查询
玛卡片几岁能吃	0	0	0	0	0	0	0	0	0	0	0	0	0	0	0		批量查询
美国玛卡250 粒	0	0	0	0	0	0	0	0	0	0	0	0	0	0	0		批量查询
美国玛卡 正品代购	0	0	0	0	0	0	0	0	0	0	0	0	0	0	0		批量查询
美国玛卡红金黑金	0	0	0	0	0	0	0	0	0	0	0	0	0	0	0		批量查询
美国玛卡片	0	0	0	0	0	0	0	0	0	0	0	0	0	0	0		批量查询
美国玛卡根	0	0	0	0	0	0	0	0	0	0	0	0	0	0	0		批量查询
美国玛卡秘鲁	0	0	0	0	0	0	0	0	0	0	0	0	0	0	0		批量查询
美国玛卡秘鲁正品	0	0	0	0	0	0	0	0	0	0	0	0	0	0	0		批量查询
美国植物草本v8玛卡	0	0	0	0	0	0	0	0	0	0	0	0	0	0	0		批量查询
男性壮阳延时口服药品黄金玛卡	0	0	0	0	0	0	0	0	0	0	0	0	0	0	0		批量查询
玛卡片 多长时间 起效	0	0	0	0	0	0	0	0	0	0	0	0	0	0	0		批量查询
玛卡壮阳正品	0	0	0	0	0	0	0	0	0	0	0	0	0	0	0		批量查询
玛咖 玛卡精片	0	0	0	0	0	0	0	0	0	0	0	0	0	0	0		批量查询
壮阳延时 玛卡	0	0	0	0	0	0	0	0	0	0	0	0	0	0	0		批量查询
正品玛卡益康片	0	0	0	0	0	0	0	0	0	0	0	0	0	0	0		批量查询
玛卡片吃了上火吗	0	0	0	0	0	0	0	0	0	0	0	0	0	0	0		批量查询
玛卡片的味道	0	0	0	0	0	0	0	0	0	0	0	0	0	0	0		批量查询
玛卡 玛咖 补肾	0	0	0	0	0	0	0	0	0	0	0	0	0	0	0		批量查询
玛卡 玛咖黄精片	0	0	0	0	0	0	0	0	0	0	0	0	0	0	0		批量查询
玛卡 玛咖 马卡 中药	0	0	0	0	0	0	0	0	0	0	0	0	0	0	0		批量查询
玛咖酒玛卡酒	0	0	0	0	0	0	0	0	0	0	0	0	0	0	0		批量查询
玛咖玛卡干果	0	0	0	0	0	0	0	0	0	0	0	0	0	0	0		批量查询
享硬玛卡浓缩?台湾	0	0	0	0	0	0	0	0	0	0	0	0	0	0	0		批量查询
玛卡鲜果如何辨别真假	0	0	0	0	0	0	0	0	0	0	0	0	0	0	0		批量查询
如何辨别玛卡干片真假	0	0	0	0	0	0	0	0	0	0	0	0	0	0	0		批量查询
玛卡怎么辨别	0	0	0	0	0	0	0	0	0	0	0	0	0	0	0		批量查询
怎样辨别玛卡	0	0	0	0	0	0	0	0	0	0	0	0	0	0	0		批量查询
如何识别丽江玛卡真假	0	0	0	0	0	0	0	0	0	0	0	0	0	0	0		批量查询
补肾玛卡女	0	0	0	0	0	0	0	0	0	0	0	0	0	0	0		批量查询
补肾玛卡 肾虚	0	0	0	0	0	0	0	0	0	0	0	0	0	0	0		批量查询
秘鲁补肾玛卡	0	0	0	0	0	0	0	0	0	0	0	0	0	0	0		批量查询
玛卡延时增大补肾	0	0	0	0	0	0	0	0	0	0	0	0	0	0	0		批量查询
玛卡的真假分别	0	0	0	0	0	0	0	0	0	0	0	0	0	0	0		批量查询
秘鲁玛卡怎么分辨真假	0	0	0	0	0	0	0	0	0	0	0	0	0	0	0		批量查询
秘鲁玛卡怎么看真假	0	0	0	0	0	0	0	0	0	0	0	0	0	0	0		批量查询
上海总经秘鲁玛卡	0	0	0	0	0	0	0	0	0	0	0	0	0	0	0		批量查询
玛卡片 拉摩力	0	0	0	0	0	0	0	0	0	0	0	0	0	0	0		批量查询
怎样识别真假玛卡	0	0	0	0	0	0	0	0	0	0	0	0	0	0	0		批量查询
玛卡益康片真假	0	0	0	0	0	0	0	0	0	0	0	0	0	0	0		批量查询
优恩玛卡片	0	0	0	0	0	0	0	0	0	0	0	0	0	0	0		批量查询
云南丽江鲜玛卡	0	0	0	0	0	0	0	0	0	0	0	0	0	0	0		批量查询
紫玛卡种子 免运费	0	0	0	0	0	0	0	0	0	0	0	0	0	0	0		批量查询
紫玛卡种子 正品	0	0	0	0	0	0	0	0	0	0	0	0	0	0	0		批量查询
紫玛卡片	0	0	0	0	0	0	0	0	0	0	0	0	0	0	0		批量查询
新鲜紫玛卡	0	0	0	0	0	0	0	0	0	0	0	0	0	0	0		批量查询
秘鲁 紫玛卡	0	0	0	0	0	0	0	0	0	0	0	0	0	0	0		批量查询
玛卡多少钱一公斤	0	0	0	0	0	0	0	0	0	0	0	0	0	0	0		批量查询
玛卡一公斤大概多少钱	0	0	0	0	0	0	0	0	0	0	0	0	0	0	0		批量查询
1斤干玛卡多少钱	0	0	0	0	0	0	0	0	0	0	0	0	0	0	0		批量查询
鲜玛卡多少钱一公斤	0	0	0	0	0	0	0	0	0	0	0	0	0	0	0		批量查询
秘鲁黑玛卡粉	0	0	0	0	0	0	0	0	0	0	0	0	0	0	0		批量查询
紫玛卡粉	0	0	0	0	0	0	0	0	0	0	0	0	0	0	0		批量查询
紫玛卡 秘鲁 正品	0	0	0	0	0	0	0	0	0	0	0	0	0	0	0		批量查询
秘鲁黑玛卡maca进口	0	0	0	0	0	0	0	0	0	0	0	0	0	0	0		批量查询
秘鲁黑玛卡干果zhonzi	0	0	0	0	0	0	0	0	0	0	0	0	0	0	0		批量查询
秘鲁黑玛卡精片	0	0	0	0	0	0	0	0	0	0	0	0	0	0	0		批量查询
黑玛卡 秘鲁 正品	0	0	0	0	0	0	0	0	0	0	0	0	0	0	0		批量查询
恩百玛卡片有副作用吗	0	0	0	0	0	0	0	0	0	0	0	0	0	0	0		批量查询
玛卡片批发	0	0	0	0	0	0	0	0	0	0	0	0	0	0	0		批量查询
gnc秘鲁玛卡100胶囊	0	0	0	0	0	0	0	0	0	0	0	0	0	0	0		批量查询
gnc秘鲁玛卡100粒胶囊	0	0	0	0	0	0	0	0	0	0	0	0	0	0	0		批量查询
玛卡冻干果	0	0	0	0	0	0	0	0	0	0	0	0	0	0	0		批量查询
玛卡饮料加工	0	0	0	0	0	0	0	0	0	0	0	0	0	0	0		批量查询
玛卡片60片正品	0	0	0	0	0	0	0	0	0	0	0	0	0	0	0		批量查询
玛卡口服液加工	0	0	0	0	0	0	0	0	0	0	0	0	0	0	0		批量查询
玛卡的泡酒加工方法	0	0	0	0	0	0	0	0	0	0	0	0	0	0	0		批量查询
云南玛卡加工	0	0	0	0	0	0	0	0	0	0	0	0	0	0	0		批量查询
没有加工的玛卡	0	0	0	0	0	0	0	0	0	0	0	0	0	0	0		批量查询
云南玛卡加工产业政策	0	0	0	0	0	0	0	0	0	0	0	0	0	0	0		批量查询
黑玛卡效果如何	0	0	0	0	0	0	0	0	0	0	0	0	0	0	0		批量查询
极品黑玛卡	0	0	0	0	0	0	0	0	0	0	0	0	0	0	0		批量查询
黑玛卡的效果确实更好	0	0	0	0	0	0	0	0	0	0	0	0	0	0	0		批量查询
新鲜玛卡价格是多少	0	0	0	0	0	0	0	0	0	0	0	0	0	0	0		批量查询
玛卡进口认证	0	0	0	0	0	0	0	0	0	0	0	0	0	0	0		批量查询
玛卡进口程序	0	0	0	0	0	0	0	0	0	0	0	0	0	0	0		批量查询
玛卡进口贸易概况	0	0	0	0	0	0	0	0	0	0	0	0	0	0	0		批量查询
益康玛卡60粒	0	0	0	0	0	0	0	0	0	0	0	0	0	0	0		批量查询
玛卡长什么样子图片	0	0	0	0	0	0	0	0	0	0	0	0	0	0	0		批量查询
玛卡的样子	0	0	0	0	0	0	0	0	0	0	0	0	0	0	0		批量查询
玛卡长什么样子	0	0	0	0	0	0	0	0	0	0	0	0	0	0	0		批量查询
玛卡什么样子	0	0	0	0	0	0	0	0	0	0	0	0	0	0	0		批量查询
玛卡到底是个什么东西	0	0	0	0	0	0	0	0	0	0	0	0	0	0	0		批量查询
玛卡益康是什么东西	0	0	0	0	0	0	0	0	0	0	0	0	0	0	0		批量查询
玛卡是啥东西	0	0	0	0	0	0	0	0	0	0	0	0	0	0	0		批量查询
玛卡这东西是真的吗	0	0	0	0	0	0	0	0	0	0	0	0	0	0	0		批量查询
丽江玛卡是什么味道的	0	0	0	0	0	0	0	0	0	0	0	0	0	0	0		批量查询
黑玛卡是什么味道	0	0	0	0	0	0	0	0	0	0	0	0	0	0	0		批量查询
玛卡的味道	0	0	0	0	0	0	0	0	0	0	0	0	0	0	0		批量查询
玛卡泡水喝是什么味道	0	0	0	0	0	0	0	0	0	0	0	0	0	0	0		批量查询
玛卡干果什么味道	0	0	0	0	0	0	0	0	0	0	0	0	0	0	0		批量查询
玛卡鲜果的味道	0	0	0	0	0	0	0	0	0	0	0	0	0	0	0		批量查询
秘鲁玛卡是什么药	0	0	0	0	0	0	0	0	0	0	0	0	0	0	0		批量查询
玛卡配什么药泡酒最好	0	0	0	0	0	0	0	0	0	0	0	0	0	0	0		批量查询
玛卡是药吗	0	0	0	0	0	0	0	0	0	0	0	0	0	0	0		批量查询
玛卡药的作用	0	0	0	0	0	0	0	0	0	0	0	0	0	0	0		批量查询
日本丸荣2h2d秘鲁玛卡	0	0	0	0	0	0	0	0	0	0	0	0	0	0	0		批量查询
日本丸荣2h2d秘鲁黑钻玛卡	0	0	0	0	0	0	0	0	0	0	0	0	0	0	0		批量查询
日本原装玛卡	0	0	0	0	0	0	0	0	0	0	0	0	0	0	0		批量查询
玛卡 原装进口	0	0	0	0	0	0	0	0	0	0	0	0	0	0	0		批量查询
美国原装进口玛卡	0	0	0	0	0	0	0	0	0	0	0	0	0	0	0		批量查询
玛卡胚体精粉	0	0	0	0	0	0	0	0	0	0	0	0	0	0	0		批量查询
玛卡颜色	0	0	0	0	0	0	0	0	0	0	0	0	0	0	0		批量查询
日本玛卡皇帝伦	0	0	0	0	0	0	0	0	0	0	0	0	0	0	0		批量查询
日本玛卡 三得利	0	0	0	0	0	0	0	0	0	0	0	0	0	0	0		批量查询
日本玛卡精华	0	0	0	0	0	0	0	0	0	0	0	0	0	0	0		批量查询
日本玛卡 女性	0	0	0	0	0	0	0	0	0	0	0	0	0	0	0		批量查询
玛卡 日本进口	0	0	0	0	0	0	0	0	0	0	0	0	0	0	0		批量查询
日本明治玛卡精华片	0	0	0	0	0	0	0	0	0	0	0	0	0	0	0		批量查询
日本代购 玛卡	0	0	0	0	0	0	0	0	0	0	0	0	0	0	0		批量查询
轩庆玛卡片昆明销售点	0	0	0	0	0	0	0	0	0	0	0	0	0	0	0		批量查询
秘鲁玛卡片真的有效吗	0	0	0	0	0	0	0	0	0	0	0	0	0	0	0		批量查询
云南玛卡批发市场	0	0	0	0	0	0	0	0	0	0	0	0	0	0	0		批量查询
低价丽江玛卡批发	0	0	0	0	0	0	0	0	0	0	0	0	0	0	0		批量查询
云南玛卡批发	0	0	0	0	0	0	0	0	0	0	0	0	0	0	0		批量查询
成都玛卡批发	0	0	0	0	0	0	0	0	0	0	0	0	0	0	0		批量查询
新鲜玛卡批发	0	0	0	0	0	0	0	0	0	0	0	0	0	0	0		批量查询
服用秘鲁玛卡的副作用	0	0	0	0	0	0	0	0	0	0	0	0	0	0	0		批量查询
四川玛卡批发	0	0	0	0	0	0	0	0	0	0	0	0	0	0	0		批量查询
拉摩力拉maca玛卡	0	0	0	0	0	0	0	0	0	0	0	0	0	0	0		批量查询
玛咖 玛卡maca	0	0	0	0	0	0	0	0	0	0	0	0	0	0	0		批量查询
摩力拉maca玛卡	0	0	0	0	0	0	0	0	0	0	0	0	0	0	0		批量查询
玛卡maca干果	0	0	0	0	0	0	0	0	0	0	0	0	0	0	0		批量查询
玛卡maca胶囊	0	0	0	0	0	0	0	0	0	0	0	0	0	0	0		批量查询
玛卡代购 maca	0	0	0	0	0	0	0	0	0	0	0	0	0	0	0		批量查询
玛卡精片maca	0	0	0	0	0	0	0	0	0	0	0	0	0	0	0		批量查询
新疆玛卡种植	0	0	0	0	0	0	0	0	0	0	0	0	0	0	0		批量查询
新疆喀什玛卡	0	0	0	0	0	0	0	0	0	0	0	0	0	0	0		批量查询
玛卡含片云南	0	0	0	0	0	0	0	0	0	0	0	0	0	0	0		批量查询
玛卡养生含片	0	0	0	0	0	0	0	0	0	0	0	0	0	0	0		批量查询
古之极玛卡片	0	0	0	0	0	0	0	0	0	0	0	0	0	0	0		批量查询
松古树美牌玛卡片	0	0	0	0	0	0	0	0	0	0	0	0	0	0	0		批量查询
松古树美 男性玛卡玛	0	0	0	0	0	0	0	0	0	0	0	0	0	0	0		批量查询
代购 秘鲁 黑玛卡干果	0	0	0	0	0	0	0	0	0	0	0	0	0	0	0		批量查询
秘鲁黄玛卡干果500	0	0	0	0	0	0	0	0	0	0	0	0	0	0	0		批量查询
秘鲁玛卡女人可以吃吗	0	0	0	0	0	0	0	0	0	0	0	0	0	0	0		批量查询
玛卡片真的好吗	0	0	0	0	0	0	0	0	0	0	0	0	0	0	0		批量查询
从那里能买到真玛卡片	0	0	0	0	0	0	0	0	0	0	0	0	0	0	0		批量查询
玛卡片在哪能买到	0	0	0	0	0	0	0	0	0	0	0	0	0	0	0		批量查询
新鲜玛卡食用方法	0	0	0	0	0	0	0	0	0	0	0	0	0	0	0		批量查询
国产玛卡片	0	0	0	0	0	0	0	0	0	0	0	0	0	0	0		批量查询
国产玛卡片 牌子 好	0	0	0	0	0	0	0	0	0	0	0	0	0	0	0		批量查询
玛卡用量	0	0	0	0	0	0	0	0	0	0	0	0	0	0	0		批量查询
玛卡果与玛卡鲜果	0	0	0	0	0	0	0	0	0	0	0	0	0	0	0		批量查询
班寨玛卡	0	0	0	0	0	0	0	0	0	0	0	0	0	0	0		批量查询
佳莱福玛卡马卡	0	0	0	0	0	0	0	0	0	0	0	0	0	0	0		批量查询
草本玛卡浓缩片	0	0	0	0	0	0	0	0	0	0	0	0	0	0	0		批量查询
享硬玛卡浓缩片 正品	0	0	0	0	0	0	0	0	0	0	0	0	0	0	0		批量查询
享硬玛卡浓缩片 增大	0	0	0	0	0	0	0	0	0	0	0	0	0	0	0		批量查询
甲申享硬玛卡浓缩片	0	0	0	0	0	0	0	0	0	0	0	0	0	0	0		批量查询
享硬玛卡浓缩时片	0	0	0	0	0	0	0	0	0	0	0	0	0	0	0		批量查询
包邮享硬玛卡浓缩片	0	0	0	0	0	0	0	0	0	0	0	0	0	0	0		批量查询
伽玛卡兹鲫鱼竿	0	0	0	0	0	0	0	0	0	0	0	0	0	0	0		批量查询
武汉三和玛卡益康	0	0	0	0	0	0	0	0	0	0	0	0	0	0	0		批量查询
武汉产的玛卡益康	0	0	0	0	0	0	0	0	0	0	0	0	0	0	0		批量查询
武汉玛卡	0	0	0	0	0	0	0	0	0	0	0	0	0	0	0		批量查询
武汉有秘鲁玛卡吗	0	0	0	0	0	0	0	0	0	0	0	0	0	0	0		批量查询
玛卡武汉代理商	0	0	0	0	0	0	0	0	0	0	0	0	0	0	0		批量查询
武汉三合 玛卡	0	0	0	0	0	0	0	0	0	0	0	0	0	0	0		批量查询
有打假视频的武汉玛卡	0	0	0	0	0	0	0	0	0	0	0	0	0	0	0		批量查询
玛卡浓缩片货到付款	0	0	0	0	0	0	0	0	0	0	0	0	0	0	0		批量查询
爱司盟玛卡	0	0	0	0	0	0	0	0	0	0	0	0	0	0	0		批量查询
浓缩玛卡 秘鲁	0	0	0	0	0	0	0	0	0	0	0	0	0	0	0		批量查询
玛卡浓缩	0	0	0	0	0	0	0	0	0	0	0	0	0	0	0		批量查询
享硬玛卡浓缩片胶囊	0	0	0	0	0	0	0	0	0	0	0	0	0	0	0		批量查询
玛卡咖啡怎么样	0	0	0	0	0	0	0	0	0	0	0	0	0	0	0		批量查询
玛卡咖啡厂家	0	0	0	0	0	0	0	0	0	0	0	0	0	0	0		批量查询
逆时针玛卡咖啡怎么样	0	0	0	0	0	0	0	0	0	0	0	0	0	0	0		批量查询
玛卡咖啡喝了的感觉	0	0	0	0	0	0	0	0	0	0	0	0	0	0	0		批量查询
广州玛卡咖啡代工	0	0	0	0	0	0	0	0	0	0	0	0	0	0	0		批量查询
玛卡咖啡好用吗	0	0	0	0	0	0	0	0	0	0	0	0	0	0	0		批量查询
云南哪里收购玛卡鲜果	0	0	0	0	0	0	0	0	0	0	0	0	0	0	0		批量查询
玛卡鲜果怎么吃	0	0	0	0	0	0	0	0	0	0	0	0	0	0	0		批量查询
玛卡鲜果多少一斤	0	0	0	0	0	0	0	0	0	0	0	0	0	0	0		批量查询
哪里在收购玛卡鲜果	0	0	0	0	0	0	0	0	0	0	0	0	0	0	0		批量查询
玛卡鲜果图片	0	0	0	0	0	0	0	0	0	0	0	0	0	0	0		批量查询
玛卡鲜果如何吃	0	0	0	0	0	0	0	0	0	0	0	0	0	0	0		批量查询
gnc maca 秘鲁玛卡 60片	0	0	0	0	0	0	0	0	0	0	0	0	0	0	0		批量查询
玛卡牌子	0	0	0	0	0	0	0	0	0	0	0	0	0	0	0		批量查询
玛卡 女秘鲁 正品 补肾	0	0	0	0	0	0	0	0	0	0	0	0	0	0	0		批量查询
云南玛卡厂家企业大全	0	0	0	0	0	0	0	0	0	0	0	0	0	0	0		批量查询
云南玛卡 哪个厂家好	0	0	0	0	0	0	0	0	0	0	0	0	0	0	0		批量查询
云南香格里拉玛卡厂家	0	0	0	0	0	0	0	0	0	0	0	0	0	0	0		批量查询
诺奥玛卡效果	0	0	0	0	0	0	0	0	0	0	0	0	0	0	0		批量查询
原装玛卡精片	0	0	0	0	0	0	0	0	0	0	0	0	0	0	0		批量查询
原装玛卡保健品	0	0	0	0	0	0	0	0	0	0	0	0	0	0	0		批量查询
原装玛卡正品	0	0	0	0	0	0	0	0	0	0	0	0	0	0	0		批量查询
干玛卡要怎么吃	0	0	0	0	0	0	0	0	0	0	0	0	0	0	0		批量查询
塔尔干帕米尔玛卡	0	0	0	0	0	0	0	0	0	0	0	0	0	0	0		批量查询
新鲜玛卡好还是干的好	0	0	0	0	0	0	0	0	0	0	0	0	0	0	0		批量查询
吃秘鲁玛卡副作用	0	0	0	0	0	0	0	0	0	0	0	0	0	0	0		批量查询
鲜玛卡女人怎么吃	0	0	0	0	0	0	0	0	0	0	0	0	0	0	0		批量查询
玛卡秘鲁60粒	0	0	0	0	0	0	0	0	0	0	0	0	0	0	0		批量查询
生玛卡如何吃	0	0	0	0	0	0	0	0	0	0	0	0	0	0	0		批量查询
玛卡可以生嚼着吃吗	0	0	0	0	0	0	0	0	0	0	0	0	0	0	0		批量查询
玛卡倍斯万益康片	0	0	0	0	0	0	0	0	0	0	0	0	0	0	0		批量查询
新鲜玛卡食用	0	0	0	0	0	0	0	0	0	0	0	0	0	0	0		批量查询
黑色玛卡	0	0	0	0	0	0	0	0	0	0	0	0	0	0	0		批量查询
如何食用新鲜玛卡	0	0	0	0	0	0	0	0	0	0	0	0	0	0	0		批量查询
新鲜玛卡的保管方法	0	0	0	0	0	0	0	0	0	0	0	0	0	0	0		批量查询
玛卡一次能吃一个吗	0	0	0	0	0	0	0	0	0	0	0	0	0	0	0		批量查询
拉摩力拉maca秘鲁玛卡片	0	0	0	0	0	0	0	0	0	0	0	0	0	0	0		批量查询
丽江玛卡种子好吗	0	0	0	0	0	0	0	0	0	0	0	0	0	0	0		批量查询
丽江哪里有售玛卡种子	0	0	0	0	0	0	0	0	0	0	0	0	0	0	0		批量查询
云南丽江黑玛卡	0	0	0	0	0	0	0	0	0	0	0	0	0	0	0		批量查询
云南玛卡丽江玛卡哪个是真	0	0	0	0	0	0	0	0	0	0	0	0	0	0	0		批量查询
求购玛卡种子	0	0	0	0	0	0	0	0	0	0	0	0	0	0	0		批量查询
购买玛卡种子	0	0	0	0	0	0	0	0	0	0	0	0	0	0	0		批量查询
秘鲁蛮哥玛卡maca	0	0	0	0	0	0	0	0	0	0	0	0	0	0	0		批量查询
云南玛卡种子批发	0	0	0	0	0	0	0	0	0	0	0	0	0	0	0		批量查询
云南玛卡种子批发公司	0	0	0	0	0	0	0	0	0	0	0	0	0	0	0		批量查询
云南黑玛卡种子	0	0	0	0	0	0	0	0	0	0	0	0	0	0	0		批量查询
云南丽江玛卡玛咖	0	0	0	0	0	0	0	0	0	0	0	0	0	0	0		批量查询
云南丽江玛卡补肾	0	0	0	0	0	0	0	0	0	0	0	0	0	0	0		批量查询
云南丽江玛卡500克	0	0	0	0	0	0	0	0	0	0	0	0	0	0	0		批量查询
那里出售玛卡种子	0	0	0	0	0	0	0	0	0	0	0	0	0	0	0		批量查询
玛卡种子批发	0	0	0	0	0	0	0	0	0	0	0	0	0	0	0		批量查询
一公斤玛卡种子培苗	0	0	0	0	0	0	0	0	0	0	0	0	0	0	0		批量查询
昆明哪里有卖玛卡苗的	0	0	0	0	0	0	0	0	0	0	0	0	0	0	0		批量查询
怎样育玛卡苗	0	0	0	0	0	0	0	0	0	0	0	0	0	0	0		批量查询
云南丽江玛卡干果 500	0	0	0	0	0	0	0	0	0	0	0	0	0	0	0		批量查询
秘鲁玛卡女性服用效果	0	0	0	0	0	0	0	0	0	0	0	0	0	0	0		批量查询
美国黄金玛卡男用	0	0	0	0	0	0	0	0	0	0	0	0	0	0	0		批量查询
美国秘鲁黄金玛卡	0	0	0	0	0	0	0	0	0	0	0	0	0	0	0		批量查询
美国进口 黄金玛卡	0	0	0	0	0	0	0	0	0	0	0	0	0	0	0		批量查询
美国 时刻 黄金玛卡	0	0	0	0	0	0	0	0	0	0	0	0	0	0	0		批量查询
丽江哪里买玛卡	0	0	0	0	0	0	0	0	0	0	0	0	0	0	0		批量查询
西藏玛卡 林芝	0	0	0	0	0	0	0	0	0	0	0	0	0	0	0		批量查询
西藏玛卡是怎样的	0	0	0	0	0	0	0	0	0	0	0	0	0	0	0		批量查询
西藏玛卡农场	0	0	0	0	0	0	0	0	0	0	0	0	0	0	0		批量查询
西藏林芝特产玛卡	0	0	0	0	0	0	0	0	0	0	0	0	0	0	0		批量查询
玛卡在西藏游嘛	0	0	0	0	0	0	0	0	0	0	0	0	0	0	0		批量查询
西藏产玛卡吗	0	0	0	0	0	0	0	0	0	0	0	0	0	0	0		批量查询
货到付款玛卡干片	0	0	0	0	0	0	0	0	0	0	0	0	0	0	0		批量查询
货到付款 秘鲁玛卡	0	0	0	0	0	0	0	0	0	0	0	0	0	0	0		批量查询
哪有正品的玛卡	0	0	0	0	0	0	0	0	0	0	0	0	0	0	0		批量查询
怎样买到正品玛卡	0	0	0	0	0	0	0	0	0	0	0	0	0	0	0		批量查询
在哪里能买到正品玛卡	0	0	0	0	0	0	0	0	0	0	0	0	0	0	0		批量查询
万艾克正品玛卡	0	0	0	0	0	0	0	0	0	0	0	0	0	0	0		批量查询
怎样能买到正品玛卡	0	0	0	0	0	0	0	0	0	0	0	0	0	0	0		批量查询
乐维士玛卡提取物胶囊	0	0	0	0	0	0	0	0	0	0	0	0	0	0	0		批量查询
美国玛卡香港	0	0	0	0	0	0	0	0	0	0	0	0	0	0	0		批量查询
美国玛卡有效吗	0	0	0	0	0	0	0	0	0	0	0	0	0	0	0		批量查询
美国玛卡怎么吃好	0	0	0	0	0	0	0	0	0	0	0	0	0	0	0		批量查询
美国玛卡酰胺	0	0	0	0	0	0	0	0	0	0	0	0	0	0	0		批量查询
新鲜玛卡怎样食用	0	0	0	0	0	0	0	0	0	0	0	0	0	0	0		批量查询
玛卡在药店能买到么	0	0	0	0	0	0	0	0	0	0	0	0	0	0	0		批量查询
新疆高原玛卡	0	0	0	0	0	0	0	0	0	0	0	0	0	0	0		批量查询
玛卡能不能补肾	0	0	0	0	0	0	0	0	0	0	0	0	0	0	0		批量查询
玛卡阴阳双补	0	0	0	0	0	0	0	0	0	0	0	0	0	0	0		批量查询
玛卡阴阳双补吗	0	0	0	0	0	0	0	0	0	0	0	0	0	0	0		批量查询
玛卡是阴阳双补吗	0	0	0	0	0	0	0	0	0	0	0	0	0	0	0		批量查询
新疆玛卡干片	0	0	0	0	0	0	0	0	0	0	0	0	0	0	0		批量查询
新疆玛卡干果	0	0	0	0	0	0	0	0	0	0	0	0	0	0	0		批量查询
新疆玛卡果	0	0	0	0	0	0	0	0	0	0	0	0	0	0	0		批量查询
新疆帕米尔高原玛卡	0	0	0	0	0	0	0	0	0	0	0	0	0	0	0		批量查询
玛卡能补肾吗	0	0	0	0	0	0	0	0	0	0	0	0	0	0	0		批量查询
玛卡使用后的效果反应	0	0	0	0	0	0	0	0	0	0	0	0	0	0	0		批量查询
吃玛卡后感觉累	0	0	0	0	0	0	0	0	0	0	0	0	0	0	0		批量查询
高植玛卡玛咖精片	0	0	0	0	0	0	0	0	0	0	0	0	0	0	0		批量查询
吃了玛卡的效果图	0	0	0	0	0	0	0	0	0	0	0	0	0	0	0		批量查询
秘鲁玛卡种植	0	0	0	0	0	0	0	0	0	0	0	0	0	0	0		批量查询
玛卡怎么泡茶	0	0	0	0	0	0	0	0	0	0	0	0	0	0	0		批量查询
巨青玛卡 秘鲁 正品	0	0	0	0	0	0	0	0	0	0	0	0	0	0	0		批量查询
黑玛卡粉	0	0	0	0	0	0	0	0	0	0	0	0	0	0	0		批量查询
黑玛卡鲜果	0	0	0	0	0	0	0	0	0	0	0	0	0	0	0		批量查询
丽江黑玛卡	0	0	0	0	0	0	0	0	0	0	0	0	0	0	0		批量查询
黑玛咖玛卡干果	0	0	0	0	0	0	0	0	0	0	0	0	0	0	0		批量查询
黑玛卡 秘鲁 正品 干果	0	0	0	0	0	0	0	0	0	0	0	0	0	0	0		批量查询
玛卡官方网站是哪个	0	0	0	0	0	0	0	0	0	0	0	0	0	0	0		批量查询
天然玛卡官方网站	0	0	0	0	0	0	0	0	0	0	0	0	0	0	0		批量查询
玛米玛卡官方网站	0	0	0	0	0	0	0	0	0	0	0	0	0	0	0		批量查询
云南玛卡官方网站	0	0	0	0	0	0	0	0	0	0	0	0	0	0	0		批量查询
云南丽江玛卡官方网站	0	0	0	0	0	0	0	0	0	0	0	0	0	0	0		批量查询
黑玛卡片补肾健体	0	0	0	0	0	0	0	0	0	0	0	0	0	0	0		批量查询
黑玛卡片 正品	0	0	0	0	0	0	0	0	0	0	0	0	0	0	0		批量查询
黑玛卡片货到付款	0	0	0	0	0	0	0	0	0	0	0	0	0	0	0		批量查询
黑玛卡片批发	0	0	0	0	0	0	0	0	0	0	0	0	0	0	0		批量查询
2h2d 黑玛卡片	0	0	0	0	0	0	0	0	0	0	0	0	0	0	0		批量查询
极品黑玛卡片	0	0	0	0	0	0	0	0	0	0	0	0	0	0	0		批量查询
拉摩力拉牌黑玛卡片	0	0	0	0	0	0	0	0	0	0	0	0	0	0	0		批量查询
拉摩力拉黑玛卡片	0	0	0	0	0	0	0	0	0	0	0	0	0	0	0		批量查询
黑玛卡与黄玛卡的区别	0	0	0	0	0	0	0	0	0	0	0	0	0	0	0		批量查询
玛卡黄精片	0	0	0	0	0	0	0	0	0	0	0	0	0	0	0		批量查询
黄玛卡价格	0	0	0	0	0	0	0	0	0	0	0	0	0	0	0		批量查询
那种玛卡好	0	0	0	0	0	0	0	0	0	0	0	0	0	0	0		批量查询
玛卡那种颜色的好	0	0	0	0	0	0	0	0	0	0	0	0	0	0	0		批量查询
那种颜色玛卡比较好	0	0	0	0	0	0	0	0	0	0	0	0	0	0	0		批量查询
黑玛卡好吗	0	0	0	0	0	0	0	0	0	0	0	0	0	0	0		批量查询
黑玛卡和黄玛卡哪个好	0	0	0	0	0	0	0	0	0	0	0	0	0	0	0		批量查询
求购秘鲁玛卡种	0	0	0	0	0	0	0	0	0	0	0	0	0	0	0		批量查询
昆明玛卡	0	0	0	0	0	0	0	0	0	0	0	0	0	0	0		批量查询
云南昆明玛卡专营店	0	0	0	0	0	0	0	0	0	0	0	0	0	0	0		批量查询
云南玛卡昆明销售	0	0	0	0	0	0	0	0	0	0	0	0	0	0	0		批量查询
昆明玛卡怎么吃	0	0	0	0	0	0	0	0	0	0	0	0	0	0	0		批量查询
昆明玛卡专卖店	0	0	0	0	0	0	0	0	0	0	0	0	0	0	0		批量查询
昆明农贸市场玛卡	0	0	0	0	0	0	0	0	0	0	0	0	0	0	0		批量查询
原装正品秘鲁玛卡	0	0	0	0	0	0	0	0	0	0	0	0	0	0	0		批量查询
玛卡人工种植	0	0	0	0	0	0	0	0	0	0	0	0	0	0	0		批量查询
高原玛卡天然精片	0	0	0	0	0	0	0	0	0	0	0	0	0	0	0		批量查询
玛卡适用人群	0	0	0	0	0	0	0	0	0	0	0	0	0	0	0		批量查询
玛卡不适宜人群	0	0	0	0	0	0	0	0	0	0	0	0	0	0	0		批量查询
玛卡适合人群	0	0	0	0	0	0	0	0	0	0	0	0	0	0	0		批量查询
玛卡有激素吗	0	0	0	0	0	0	0	0	0	0	0	0	0	0	0		批量查询
玛卡含有雄性激素吗	0	0	0	0	0	0	0	0	0	0	0	0	0	0	0		批量查询
舌下含服玛卡	0	0	0	0	0	0	0	0	0	0	0	0	0	0	0		批量查询
美国进口的玛卡	0	0	0	0	0	0	0	0	0	0	0	0	0	0	0		批量查询
四川玛卡洒	0	0	0	0	0	0	0	0	0	0	0	0	0	0	0		批量查询
四川卫视现代保健玛卡	0	0	0	0	0	0	0	0	0	0	0	0	0	0	0		批量查询
四川种玛卡	0	0	0	0	0	0	0	0	0	0	0	0	0	0	0		批量查询
四川金玛卡公司	0	0	0	0	0	0	0	0	0	0	0	0	0	0	0		批量查询
四川金玛卡	0	0	0	0	0	0	0	0	0	0	0	0	0	0	0		批量查询
新鲜玛卡怎么存放	0	0	0	0	0	0	0	0	0	0	0	0	0	0	0		批量查询
玛卡秘鲁 原装进口	0	0	0	0	0	0	0	0	0	0	0	0	0	0	0		批量查询
享硬玛卡浓缩片 文号	0	0	0	0	0	0	0	0	0	0	0	0	0	0	0		批量查询
享硬玛卡浓缩片成份	0	0	0	0	0	0	0	0	0	0	0	0	0	0	0		批量查询
硬玛卡浓缩片	0	0	0	0	0	0	0	0	0	0	0	0	0	0	0		批量查询
玛卡增大	0	0	0	0	0	0	0	0	0	0	0	0	0	0	0		批量查询
黑玛卡秘鲁原装进口	0	0	0	0	0	0	0	0	0	0	0	0	0	0	0		批量查询
速效玛卡胶囊	0	0	0	0	0	0	0	0	0	0	0	0	0	0	0		批量查询
秘鲁玛卡粉原装进口	0	0	0	0	0	0	0	0	0	0	0	0	0	0	0		批量查询
玛卡对女人的作用	0	0	0	0	0	0	0	0	0	0	0	0	0	0	0		批量查询
玛卡对女人的功效	0	0	0	0	0	0	0	0	0	0	0	0	0	0	0		批量查询
香港进口玛卡	0	0	0	0	0	0	0	0	0	0	0	0	0	0	0		批量查询
进口玛卡干片	0	0	0	0	0	0	0	0	0	0	0	0	0	0	0		批量查询
进口玛卡精片	0	0	0	0	0	0	0	0	0	0	0	0	0	0	0		批量查询
进口玛卡片	0	0	0	0	0	0	0	0	0	0	0	0	0	0	0		批量查询
进口玛卡 正品	0	0	0	0	0	0	0	0	0	0	0	0	0	0	0		批量查询
进口玛卡种子	0	0	0	0	0	0	0	0	0	0	0	0	0	0	0		批量查询
进口玛卡旗舰店	0	0	0	0	0	0	0	0	0	0	0	0	0	0	0		批量查询
进口玛卡maca胶囊	0	0	0	0	0	0	0	0	0	0	0	0	0	0	0		批量查询
now foods 诺奥 秘鲁玛卡	0	0	0	0	0	0	0	0	0	0	0	0	0	0	0		批量查询
now 诺奥 玛卡	0	0	0	0	0	0	0	0	0	0	0	0	0	0	0		批量查询
会泽玛卡图片	0	0	0	0	0	0	0	0	0	0	0	0	0	0	0		批量查询
植物玛卡的食用方法	0	0	0	0	0	0	0	0	0	0	0	0	0	0	0		批量查询
玛卡 玛咖 玛卡干果	0	0	0	0	0	0	0	0	0	0	0	0	0	0	0		批量查询
干玛卡如何食用	0	0	0	0	0	0	0	0	0	0	0	0	0	0	0		批量查询
玛卡干食用	0	0	0	0	0	0	0	0	0	0	0	0	0	0	0		批量查询
干玛卡果	0	0	0	0	0	0	0	0	0	0	0	0	0	0	0		批量查询
玛卡功效和作用	0	0	0	0	0	0	0	0	0	0	0	0	0	0	0		批量查询
生玛卡的食用方法	0	0	0	0	0	0	0	0	0	0	0	0	0	0	0		批量查询
晒干的玛卡如何食用	0	0	0	0	0	0	0	0	0	0	0	0	0	0	0		批量查询
玛卡晒干后怎么吃	0	0	0	0	0	0	0	0	0	0	0	0	0	0	0		批量查询
玛卡怎么晒干	0	0	0	0	0	0	0	0	0	0	0	0	0	0	0		批量查询
晒干的玛卡怎么吃	0	0	0	0	0	0	0	0	0	0	0	0	0	0	0		批量查询
玛卡秘鲁 原装进口女	0	0	0	0	0	0	0	0	0	0	0	0	0	0	0		批量查询
秘鲁原装玛卡	0	0	0	0	0	0	0	0	0	0	0	0	0	0	0		批量查询
秘鲁原装黑玛卡粉	0	0	0	0	0	0	0	0	0	0	0	0	0	0	0		批量查询
秘鲁maca原装玛卡	0	0	0	0	0	0	0	0	0	0	0	0	0	0	0		批量查询
黑玛卡功效	0	0	0	0	0	0	0	0	0	0	0	0	0	0	0		批量查询
原装秘鲁玛卡精片	0	0	0	0	0	0	0	0	0	0	0	0	0	0	0		批量查询
会泽玛卡干果	0	0	0	0	0	0	0	0	0	0	0	0	0	0	0		批量查询
云南玛卡收购公司	0	0	0	0	0	0	0	0	0	0	0	0	0	0	0		批量查询
秘鲁原装进口玛卡 120	0	0	0	0	0	0	0	0	0	0	0	0	0	0	0		批量查询
云南玛卡收购商	0	0	0	0	0	0	0	0	0	0	0	0	0	0	0		批量查询
哪里有收购玛卡的	0	0	0	0	0	0	0	0	0	0	0	0	0	0	0		批量查询
玛咖与玛卡有区别吗	0	0	0	0	0	0	0	0	0	0	0	0	0	0	0		批量查询
玛咖和玛卡有区别么	0	0	0	0	0	0	0	0	0	0	0	0	0	0	0		批量查询
秘鲁原装黑玛卡干果	0	0	0	0	0	0	0	0	0	0	0	0	0	0	0		批量查询
玛卡 糊化	0	0	0	0	0	0	0	0	0	0	0	0	0	0	0		批量查询
丽江玛卡与秘鲁玛卡	0	0	0	0	0	0	0	0	0	0	0	0	0	0	0		批量查询
丽江黑玛卡500g干果	0	0	0	0	0	0	0	0	0	0	0	0	0	0	0		批量查询
新鲜玛卡煲汤	0	0	0	0	0	0	0	0	0	0	0	0	0	0	0		批量查询
康比特加金装玛卡	0	0	0	0	0	0	0	0	0	0	0	0	0	0	0		批量查询
玛卡是美国产的吗	0	0	0	0	0	0	0	0	0	0	0	0	0	0	0		批量查询
云南玛卡好吗	0	0	0	0	0	0	0	0	0	0	0	0	0	0	0		批量查询
原装玛卡官方旗店	0	0	0	0	0	0	0	0	0	0	0	0	0	0	0		批量查询
原装玛卡在哪里能买到	0	0	0	0	0	0	0	0	0	0	0	0	0	0	0		批量查询
新鲜玛卡的价格	0	0	0	0	0	0	0	0	0	0	0	0	0	0	0		批量查询
玛卡视频下载	0	0	0	0	0	0	0	0	0	0	0	0	0	0	0		批量查询
丽江玛卡视频	0	0	0	0	0	0	0	0	0	0	0	0	0	0	0		批量查询
玛卡倍斯万真假鉴别	0	0	0	0	0	0	0	0	0	0	0	0	0	0	0		批量查询
玛卡中国产地	0	0	0	0	0	0	0	0	0	0	0	0	0	0	0		批量查询
秘鲁蛮哥玛卡	0	0	0	0	0	0	0	0	0	0	0	0	0	0	0		批量查询
活力达 玛卡	0	0	0	0	0	0	0	0	0	0	0	0	0	0	0		批量查询
活力达秘鲁玛卡	0	0	0	0	0	0	0	0	0	0	0	0	0	0	0		批量查询
活力达玛卡90片	0	0	0	0	0	0	0	0	0	0	0	0	0	0	0		批量查询
玛卡鉴别	0	0	0	0	0	0	0	0	0	0	0	0	0	0	0		批量查询
高原玛卡高原精片	0	0	0	0	0	0	0	0	0	0	0	0	0	0	0		批量查询
丽江高原玛卡	0	0	0	0	0	0	0	0	0	0	0	0	0	0	0		批量查询
高原黄玛卡	0	0	0	0	0	0	0	0	0	0	0	0	0	0	0		批量查询
丽江玛卡 高原玛卡片	0	0	0	0	0	0	0	0	0	0	0	0	0	0	0		批量查询
迈卡高原玛卡	0	0	0	0	0	0	0	0	0	0	0	0	0	0	0		批量查询
秘鲁新鲜玛卡	0	0	0	0	0	0	0	0	0	0	0	0	0	0	0		批量查询
元素玛卡精片	0	0	0	0	0	0	0	0	0	0	0	0	0	0	0		批量查询
元素玛卡礼盒	0	0	0	0	0	0	0	0	0	0	0	0	0	0	0		批量查询
元素玛卡补肾	0	0	0	0	0	0	0	0	0	0	0	0	0	0	0		批量查询
元素牌玛卡精片	0	0	0	0	0	0	0	0	0	0	0	0	0	0	0		批量查询
购美国黄金玛卡	0	0	0	0	0	0	0	0	0	0	0	0	0	0	0		批量查询
云南玛卡鲜果500克	0	0	0	0	0	0	0	0	0	0	0	0	0	0	0		批量查询
玛卡稀	0	0	0	0	0	0	0	0	0	0	0	0	0	0	0		批量查询
植物玛卡图片	0	0	0	0	0	0	0	0	0	0	0	0	0	0	0		批量查询
新鲜玛卡鲜果	0	0	0	0	0	0	0	0	0	0	0	0	0	0	0		批量查询
新鲜玛卡 玛咖鲜果	0	0	0	0	0	0	0	0	0	0	0	0	0	0	0		批量查询
云南新鲜玛卡	0	0	0	0	0	0	0	0	0	0	0	0	0	0	0		批量查询
紫色新鲜玛卡	0	0	0	0	0	0	0	0	0	0	0	0	0	0	0		批量查询
玛卡秘鲁正品 新鲜	0	0	0	0	0	0	0	0	0	0	0	0	0	0	0		批量查询
玛卡精粉	0	0	0	0	0	0	0	0	0	0	0	0	0	0	0		批量查询
玛卡精粉有几种比例	0	0	0	0	0	0	0	0	0	0	0	0	0	0	0		批量查询
玛卡果什么颜色的最好	0	0	0	0	0	0	0	0	0	0	0	0	0	0	0		批量查询
哪种颜色的玛卡好	0	0	0	0	0	0	0	0	0	0	0	0	0	0	0		批量查询
玛卡哪种好颜色的好	0	0	0	0	0	0	0	0	0	0	0	0	0	0	0		批量查询
玛卡颜色的功效	0	0	0	0	0	0	0	0	0	0	0	0	0	0	0		批量查询
秘鲁是否允许出口玛卡	0	0	0	0	0	0	0	0	0	0	0	0	0	0	0		批量查询
秘鲁如何出口玛卡	0	0	0	0	0	0	0	0	0	0	0	0	0	0	0		批量查询
秘鲁出口玛卡	0	0	0	0	0	0	0	0	0	0	0	0	0	0	0		批量查询
秘鲁禁止出口玛卡	0	0	0	0	0	0	0	0	0	0	0	0	0	0	0		批量查询
秘鲁玛卡干多少钱	0	0	0	0	0	0	0	0	0	0	0	0	0	0	0		批量查询
秘鲁 玛卡maca 代购	0	0	0	0	0	0	0	0	0	0	0	0	0	0	0		批量查询
蛮哥玛卡秘鲁代购	0	0	0	0	0	0	0	0	0	0	0	0	0	0	0		批量查询
女士玛卡秘鲁代购	0	0	0	0	0	0	0	0	0	0	0	0	0	0	0		批量查询
秘鲁进口玛卡 代购	0	0	0	0	0	0	0	0	0	0	0	0	0	0	0		批量查询
秘鲁玛卡代购 包邮	0	0	0	0	0	0	0	0	0	0	0	0	0	0	0		批量查询
黑玛卡秘鲁代购	0	0	0	0	0	0	0	0	0	0	0	0	0	0	0		批量查询
拉摩力拉牌玛卡60片	0	0	0	0	0	0	0	0	0	0	0	0	0	0	0		批量查询
拉摩力拉牌玛卡 女	0	0	0	0	0	0	0	0	0	0	0	0	0	0	0		批量查询
拉摩力拉牌玛卡30片	0	0	0	0	0	0	0	0	0	0	0	0	0	0	0		批量查询
云南秘鲁玛卡	0	0	0	0	0	0	0	0	0	0	0	0	0	0	0		批量查询
玛卡益康片管用吗	0	0	0	0	0	0	0	0	0	0	0	0	0	0	0		批量查询
玛卡 秘鲁原装货到付款	0	0	0	0	0	0	0	0	0	0	0	0	0	0	0		批量查询
关于玛卡真的管用吗	0	0	0	0	0	0	0	0	0	0	0	0	0	0	0		批量查询
香港秘鲁玛卡清关公司	0	0	0	0	0	0	0	0	0	0	0	0	0	0	0		批量查询
秘鲁玛卡香港清关	0	0	0	0	0	0	0	0	0	0	0	0	0	0	0		批量查询
男性保健品玛卡	0	0	0	0	0	0	0	0	0	0	0	0	0	0	0		批量查询
2h2d精之自信黑玛卡	0	0	0	0	0	0	0	0	0	0	0	0	0	0	0		批量查询
新疆玛卡酒	0	0	0	0	0	0	0	0	0	0	0	0	0	0	0		批量查询
新疆玛卡产地	0	0	0	0	0	0	0	0	0	0	0	0	0	0	0		批量查询
新疆玛卡的功效	0	0	0	0	0	0	0	0	0	0	0	0	0	0	0		批量查询
新疆玛卡使用方法	0	0	0	0	0	0	0	0	0	0	0	0	0	0	0		批量查询
玛卡粉提取物	0	0	0	0	0	0	0	0	0	0	0	0	0	0	0		批量查询
唐山女用玛卡价格	0	0	0	0	0	0	0	0	0	0	0	0	0	0	0		批量查询
秘鲁拉摩力拉牌玛卡片	0	0	0	0	0	0	0	0	0	0	0	0	0	0	0		批量查询
云南黑玛卡	0	0	0	0	0	0	0	0	0	0	0	0	0	0	0		批量查询
迈卡牌玛卡天然糖片	0	0	0	0	0	0	0	0	0	0	0	0	0	0	0		批量查询
lamolina拉摩力拉玛卡片	0	0	0	0	0	0	0	0	0	0	0	0	0	0	0		批量查询
迈卡牌玛卡	0	0	0	0	0	0	0	0	0	0	0	0	0	0	0		批量查询
玛卡精勃力益身宝片	0	0	0	0	0	0	0	0	0	0	0	0	0	0	0		批量查询
益诺玛卡片怎么样	0	0	0	0	0	0	0	0	0	0	0	0	0	0	0		批量查询
玛卡用法	0	0	0	0	0	0	0	0	0	0	0	0	0	0	0		批量查询
丽江玛卡用法用量	0	0	0	0	0	0	0	0	0	0	0	0	0	0	0		批量查询
巨青玛卡官网	0	0	0	0	0	0	0	0	0	0	0	0	0	0	0		批量查询
玛卡 搜搜百科	0	0	0	0	0	0	0	0	0	0	0	0	0	0	0		批量查询
玛卡饮品加工	0	0	0	0	0	0	0	0	0	0	0	0	0	0	0		批量查询
迈卡牌玛卡玛咖片	0	0	0	0	0	0	0	0	0	0	0	0	0	0	0		批量查询
丽江玛卡玛咖片	0	0	0	0	0	0	0	0	0	0	0	0	0	0	0		批量查询
云南药材玛卡	0	0	0	0	0	0	0	0	0	0	0	0	0	0	0		批量查询
云南现在哪里收购玛卡	0	0	0	0	0	0	0	0	0	0	0	0	0	0	0		批量查询
云南曲靖哪里收购玛卡	0	0	0	0	0	0	0	0	0	0	0	0	0	0	0		批量查询
云南玛卡收购	0	0	0	0	0	0	0	0	0	0	0	0	0	0	0		批量查询
云南省会泽县矿山方圆玛卡种植专业合作社	0	0	0	0	0	0	0	0	0	0	0	0	0	0	0		批量查询
玛咖云南玛卡干果	0	0	0	0	0	0	0	0	0	0	0	0	0	0	0		批量查询
玛卡丽江玛咖干果	0	0	0	0	0	0	0	0	0	0	0	0	0	0	0		批量查询
玛卡干果 优质玛咖	0	0	0	0	0	0	0	0	0	0	0	0	0	0	0		批量查询
玛卡干果玛咖精片	0	0	0	0	0	0	0	0	0	0	0	0	0	0	0		批量查询
玛卡 云南产	0	0	0	0	0	0	0	0	0	0	0	0	0	0	0		批量查询
云南那里产玛卡	0	0	0	0	0	0	0	0	0	0	0	0	0	0	0		批量查询
云南产的玛卡是什么	0	0	0	0	0	0	0	0	0	0	0	0	0	0	0		批量查询
天然玛卡有效果么	0	0	0	0	0	0	0	0	0	0	0	0	0	0	0		批量查询
天然玛卡怎么吃	0	0	0	0	0	0	0	0	0	0	0	0	0	0	0		批量查询
云南玛卡效果怎么样	0	0	0	0	0	0	0	0	0	0	0	0	0	0	0		批量查询
玛卡谁用过效果怎么样	0	0	0	0	0	0	0	0	0	0	0	0	0	0	0		批量查询
玛卡粉碎机	0	0	0	0	0	0	0	0	0	0	0	0	0	0	0		批量查询
玛卡酒的制作	0	0	0	0	0	0	0	0	0	0	0	0	0	0	0		批量查询
玛卡天然手工皂	0	0	0	0	0	0	0	0	0	0	0	0	0	0	0		批量查询
哪里买玛卡益康片	0	0	0	0	0	0	0	0	0	0	0	0	0	0	0		批量查询
那里买玛卡益康片	0	0	0	0	0	0	0	0	0	0	0	0	0	0	0		批量查询
秘鲁玛卡哪个牌子好	0	0	0	0	0	0	0	0	0	0	0	0	0	0	0		批量查询
女人吃玛卡精片	0	0	0	0	0	0	0	0	0	0	0	0	0	0	0		批量查询
玛卡粉 进口	0	0	0	0	0	0	0	0	0	0	0	0	0	0	0		批量查询
女性能服用玛卡吗	0	0	0	0	0	0	0	0	0	0	0	0	0	0	0		批量查询
女性服用玛卡的作用	0	0	0	0	0	0	0	0	0	0	0	0	0	0	0		批量查询
老年人能服用玛卡吗	0	0	0	0	0	0	0	0	0	0	0	0	0	0	0		批量查询
服用玛卡有效果吗	0	0	0	0	0	0	0	0	0	0	0	0	0	0	0		批量查询
赫明堂玛卡微精片	0	0	0	0	0	0	0	0	0	0	0	0	0	0	0		批量查询
赫名堂玛卡	0	0	0	0	0	0	0	0	0	0	0	0	0	0	0		批量查询
玛卡微精片	0	0	0	0	0	0	0	0	0	0	0	0	0	0	0		批量查询
松原哪家卖玛卡微精片	0	0	0	0	0	0	0	0	0	0	0	0	0	0	0		批量查询
玛卡粉的用法和用量	0	0	0	0	0	0	0	0	0	0	0	0	0	0	0		批量查询
玛卡的用量	0	0	0	0	0	0	0	0	0	0	0	0	0	0	0		批量查询
玛卡的用量是多少	0	0	0	0	0	0	0	0	0	0	0	0	0	0	0		批量查询
丽江百岁坊玛卡用量	0	0	0	0	0	0	0	0	0	0	0	0	0	0	0		批量查询
玛卡益康的用量	0	0	0	0	0	0	0	0	0	0	0	0	0	0	0		批量查询
玛卡干果的用法用量	0	0	0	0	0	0	0	0	0	0	0	0	0	0	0		批量查询
鲆玛卡用量多少	0	0	0	0	0	0	0	0	0	0	0	0	0	0	0		批量查询
孕妇能吃玛卡	0	0	0	0	0	0	0	0	0	0	0	0	0	0	0		批量查询
糖尿病能吃玛卡果吗	0	0	0	0	0	0	0	0	0	0	0	0	0	0	0		批量查询
吃玛卡可以喝茶茶吗	0	0	0	0	0	0	0	0	0	0	0	0	0	0	0		批量查询
玛卡能当茶泡着喝吗	0	0	0	0	0	0	0	0	0	0	0	0	0	0	0		批量查询
玛卡泡过酒还可以吃吗	0	0	0	0	0	0	0	0	0	0	0	0	0	0	0		批量查询
中药材玛卡原药怎么吃	0	0	0	0	0	0	0	0	0	0	0	0	0	0	0		批量查询
野生玛卡作用	0	0	0	0	0	0	0	0	0	0	0	0	0	0	0		批量查询
丽江生产的玛卡	0	0	0	0	0	0	0	0	0	0	0	0	0	0	0		批量查询
玛卡好药师	0	0	0	0	0	0	0	0	0	0	0	0	0	0	0		批量查询
黑玛卡干片 黑玛咖	0	0	0	0	0	0	0	0	0	0	0	0	0	0	0		批量查询
黑玛卡干片正品	0	0	0	0	0	0	0	0	0	0	0	0	0	0	0		批量查询
黑玛卡干片丽江maca	0	0	0	0	0	0	0	0	0	0	0	0	0	0	0		批量查询
黑玛卡干片100g	0	0	0	0	0	0	0	0	0	0	0	0	0	0	0		批量查询
云南玛卡粉	0	0	0	0	0	0	0	0	0	0	0	0	0	0	0		批量查询
玛卡干果粉	0	0	0	0	0	0	0	0	0	0	0	0	0	0	0		批量查询
国产玛卡哪个牌子的好	0	0	0	0	0	0	0	0	0	0	0	0	0	0	0		批量查询
玛卡那个牌子的好	0	0	0	0	0	0	0	0	0	0	0	0	0	0	0		批量查询
玛卡干片哪个牌子好	0	0	0	0	0	0	0	0	0	0	0	0	0	0	0		批量查询
哪种牌子的玛卡比较好	0	0	0	0	0	0	0	0	0	0	0	0	0	0	0		批量查询
什么牌子玛卡干果好	0	0	0	0	0	0	0	0	0	0	0	0	0	0	0		批量查询
国外和国内玛卡的区别	0	0	0	0	0	0	0	0	0	0	0	0	0	0	0		批量查询
国内玛卡那家生产的好	0	0	0	0	0	0	0	0	0	0	0	0	0	0	0		批量查询
国内玛卡哪个好	0	0	0	0	0	0	0	0	0	0	0	0	0	0	0		批量查询
国内最好的玛卡	0	0	0	0	0	0	0	0	0	0	0	0	0	0	0		批量查询
玛卡粉正品	0	0	0	0	0	0	0	0	0	0	0	0	0	0	0		批量查询
享硬玛卡管用吗	0	0	0	0	0	0	0	0	0	0	0	0	0	0	0		批量查询
有机玛卡粉	0	0	0	0	0	0	0	0	0	0	0	0	0	0	0		批量查询
玛卡管用么	0	0	0	0	0	0	0	0	0	0	0	0	0	0	0		批量查询
斯旺森玛卡怎么样	0	0	0	0	0	0	0	0	0	0	0	0	0	0	0		批量查询
阴虚火旺 玛咖 玛卡	0	0	0	0	0	0	0	0	0	0	0	0	0	0	0		批量查询
纽斯康玛卡糖果片	0	0	0	0	0	0	0	0	0	0	0	0	0	0	0		批量查询
哪里能买到正品的玛卡	0	0	0	0	0	0	0	0	0	0	0	0	0	0	0		批量查询
新鲜玛卡如何泡酒	0	0	0	0	0	0	0	0	0	0	0	0	0	0	0		批量查询
美国诺奥玛卡胶囊好吗	0	0	0	0	0	0	0	0	0	0	0	0	0	0	0		批量查询
诺奥玛卡怎么样	0	0	0	0	0	0	0	0	0	0	0	0	0	0	0		批量查询
玛卡一次吃多少	0	0	0	0	0	0	0	0	0	0	0	0	0	0	0		批量查询
活力达秘鲁进口玛卡精片90片\/瓶	0	0	0	0	0	0	0	0	0	0	0	0	0	0	0		批量查询
吃玛卡胶囊可以喝茶吗	0	0	0	0	0	0	0	0	0	0	0	0	0	0	0		批量查询
玛卡胶囊怎么吃	0	0	0	0	0	0	0	0	0	0	0	0	0	0	0		批量查询
玛卡胶囊怎样吃	0	0	0	0	0	0	0	0	0	0	0	0	0	0	0		批量查询
丽江产玛卡	0	0	0	0	0	0	0	0	0	0	0	0	0	0	0		批量查询
玛卡龙 t恤女	0	0	0	0	0	0	0	0	0	0	0	0	0	0	0		批量查询
玛卡和玛咖一样的吗	0	0	0	0	0	0	0	0	0	0	0	0	0	0	0		批量查询
玛卡产地直销	0	0	0	0	0	0	0	0	0	0	0	0	0	0	0		批量查询
秘鲁原产地玛卡	0	0	0	0	0	0	0	0	0	0	0	0	0	0	0		批量查询
玛卡和玛咖是同样	0	0	0	0	0	0	0	0	0	0	0	0	0	0	0		批量查询
玛卡和玛咖是不是一样	0	0	0	0	0	0	0	0	0	0	0	0	0	0	0		批量查询
云南天根玛卡产业	0	0	0	0	0	0	0	0	0	0	0	0	0	0	0		批量查询
maca玛卡根	0	0	0	0	0	0	0	0	0	0	0	0	0	0	0		批量查询
天根玛卡	0	0	0	0	0	0	0	0	0	0	0	0	0	0	0		批量查询
玛卡根	0	0	0	0	0	0	0	0	0	0	0	0	0	0	0		批量查询
古之极玛卡的功效	0	0	0	0	0	0	0	0	0	0	0	0	0	0	0		批量查询
古之极玛卡官网	0	0	0	0	0	0	0	0	0	0	0	0	0	0	0		批量查询
新疆玛卡粉	0	0	0	0	0	0	0	0	0	0	0	0	0	0	0		批量查询
中药材文山三七玛卡	0	0	0	0	0	0	0	0	0	0	0	0	0	0	0		批量查询
文山哪里有玛卡卖	0	0	0	0	0	0	0	0	0	0	0	0	0	0	0		批量查询
文山鑫瑞玛卡公司	0	0	0	0	0	0	0	0	0	0	0	0	0	0	0		批量查询
会泽玛卡联系电话	0	0	0	0	0	0	0	0	0	0	0	0	0	0	0		批量查询
会泽玛卡店	0	0	0	0	0	0	0	0	0	0	0	0	0	0	0		批量查询
松古树美玛卡片好用吗	0	0	0	0	0	0	0	0	0	0	0	0	0	0	0		批量查询
女性玛卡	0	0	0	0	0	0	0	0	0	0	0	0	0	0	0		批量查询
贫血女性玛卡	0	0	0	0	0	0	0	0	0	0	0	0	0	0	0		批量查询
玛卡女性专用	0	0	0	0	0	0	0	0	0	0	0	0	0	0	0		批量查询
女性保健品 玛卡	0	0	0	0	0	0	0	0	0	0	0	0	0	0	0		批量查询
女性玛卡秘鲁正品	0	0	0	0	0	0	0	0	0	0	0	0	0	0	0		批量查询
玛卡 补肾女性	0	0	0	0	0	0	0	0	0	0	0	0	0	0	0		批量查询
女性玛卡精片	0	0	0	0	0	0	0	0	0	0	0	0	0	0	0		批量查询
女性用玛卡	0	0	0	0	0	0	0	0	0	0	0	0	0	0	0		批量查询
玛卡图 女 鞋	0	0	0	0	0	0	0	0	0	0	0	0	0	0	0		批量查询
秘鲁玛卡女	0	0	0	0	0	0	0	0	0	0	0	0	0	0	0		批量查询
进口补肾玛卡女	0	0	0	0	0	0	0	0	0	0	0	0	0	0	0		批量查询
玛卡女外用	0	0	0	0	0	0	0	0	0	0	0	0	0	0	0		批量查询
玛卡秘鲁正品 女	0	0	0	0	0	0	0	0	0	0	0	0	0	0	0		批量查询
玛卡酰胺 玛卡烯	0	0	0	0	0	0	0	0	0	0	0	0	0	0	0		批量查询
玛卡酰胺40	0	0	0	0	0	0	0	0	0	0	0	0	0	0	0		批量查询
玛卡酰胺98	0	0	0	0	0	0	0	0	0	0	0	0	0	0	0		批量查询
漫草汇植物玛卡精油	0	0	0	0	0	0	0	0	0	0	0	0	0	0	0		批量查询
重庆能买到秘鲁玛卡吗	0	0	0	0	0	0	0	0	0	0	0	0	0	0	0		批量查询
丽江玛卡粉	0	0	0	0	0	0	0	0	0	0	0	0	0	0	0		批量查询
玛卡粉片	0	0	0	0	0	0	0	0	0	0	0	0	0	0	0		批量查询
秘鲁玛卡的最大产量	0	0	0	0	0	0	0	0	0	0	0	0	0	0	0		批量查询
秘鲁天然玛卡	0	0	0	0	0	0	0	0	0	0	0	0	0	0	0		批量查询
玛卡孕妇能吃吗	0	0	0	0	0	0	0	0	0	0	0	0	0	0	0		批量查询
孕妇可以吃玛卡	0	0	0	0	0	0	0	0	0	0	0	0	0	0	0		批量查询
孕妇吃玛卡	0	0	0	0	0	0	0	0	0	0	0	0	0	0	0		批量查询
孕妇能吃玛卡么	0	0	0	0	0	0	0	0	0	0	0	0	0	0	0		批量查询
孕妇能吃玛卡炖鸡吗	0	0	0	0	0	0	0	0	0	0	0	0	0	0	0		批量查询
孕妇能不能吃玛卡	0	0	0	0	0	0	0	0	0	0	0	0	0	0	0		批量查询
孕妇可以吃玛卡么	0	0	0	0	0	0	0	0	0	0	0	0	0	0	0		批量查询
纯天然植物玛卡	0	0	0	0	0	0	0	0	0	0	0	0	0	0	0		批量查询
玛卡原植物	0	0	0	0	0	0	0	0	0	0	0	0	0	0	0		批量查询
轩庆 玛卡 秘鲁	0	0	0	0	0	0	0	0	0	0	0	0	0	0	0		批量查询
玛卡可以长期服用吗	0	0	0	0	0	0	0	0	0	0	0	0	0	0	0		批量查询
玛卡能长期服用吗	0	0	0	0	0	0	0	0	0	0	0	0	0	0	0		批量查询
丽江玛卡批发零售中心	0	0	0	0	0	0	0	0	0	0	0	0	0	0	0		批量查询
药材玛卡怎样食用	0	0	0	0	0	0	0	0	0	0	0	0	0	0	0		批量查询
中药材玛卡怎样使用	0	0	0	0	0	0	0	0	0	0	0	0	0	0	0		批量查询
玛卡怎样泡酒	0	0	0	0	0	0	0	0	0	0	0	0	0	0	0		批量查询
玛卡酒怎样泡	0	0	0	0	0	0	0	0	0	0	0	0	0	0	0		批量查询
轩庆玛卡50片正品	0	0	0	0	0	0	0	0	0	0	0	0	0	0	0		批量查询
轩庆玛卡片	0	0	0	0	0	0	0	0	0	0	0	0	0	0	0		批量查询
轩庆玛卡100片正品	0	0	0	0	0	0	0	0	0	0	0	0	0	0	0		批量查询
轩庆玛卡精片150片	0	0	0	0	0	0	0	0	0	0	0	0	0	0	0		批量查询
轩庆玛卡50片	0	0	0	0	0	0	0	0	0	0	0	0	0	0	0		批量查询
轩庆玛卡精片	0	0	0	0	0	0	0	0	0	0	0	0	0	0	0		批量查询
轩庆玛卡精片100片	0	0	0	0	0	0	0	0	0	0	0	0	0	0	0		批量查询
轩庆丽江玛卡	0	0	0	0	0	0	0	0	0	0	0	0	0	0	0		批量查询
玛卡中药店有卖吗	0	0	0	0	0	0	0	0	0	0	0	0	0	0	0		批量查询
云南丽江紫玛卡批发	0	0	0	0	0	0	0	0	0	0	0	0	0	0	0		批量查询
云南玛卡 丽江批发	0	0	0	0	0	0	0	0	0	0	0	0	0	0	0		批量查询
天然玛卡有什么作?	0	0	0	0	0	0	0	0	0	0	0	0	0	0	0		批量查询
天然玛卡图片	0	0	0	0	0	0	0	0	0	0	0	0	0	0	0		批量查询
上方堂玛卡精片	0	0	0	0	0	0	0	0	0	0	0	0	0	0	0		批量查询
玛米玛卡男童夏短袖	0	0	0	0	0	0	0	0	0	0	0	0	0	0	0		批量查询
玛卡玛嘉加盟	0	0	0	0	0	0	0	0	0	0	0	0	0	0	0		批量查询
滁州玛卡玛嘉	0	0	0	0	0	0	0	0	0	0	0	0	0	0	0		批量查询
玛卡玛嘉蛋糕	0	0	0	0	0	0	0	0	0	0	0	0	0	0	0		批量查询
玛米玛卡男童t恤 夏	0	0	0	0	0	0	0	0	0	0	0	0	0	0	0		批量查询
玛米玛卡 男童 长裤 薄	0	0	0	0	0	0	0	0	0	0	0	0	0	0	0		批量查询
玛米玛卡男童裤子薄	0	0	0	0	0	0	0	0	0	0	0	0	0	0	0		批量查询
玛米玛卡男童裤子秋	0	0	0	0	0	0	0	0	0	0	0	0	0	0	0		批量查询
游仙尚选玛卡是真的吗	0	0	0	0	0	0	0	0	0	0	0	0	0	0	0		批量查询
网上卖得玛卡是真的吗	0	0	0	0	0	0	0	0	0	0	0	0	0	0	0		批量查询
安徽卖的玛卡是真的吗	0	0	0	0	0	0	0	0	0	0	0	0	0	0	0		批量查询
秘玛卡是真的吗	0	0	0	0	0	0	0	0	0	0	0	0	0	0	0		批量查询
玛卡玛卡童装	0	0	0	0	0	0	0	0	0	0	0	0	0	0	0		批量查询
玛米玛卡女童裙子夏	0	0	0	0	0	0	0	0	0	0	0	0	0	0	0		批量查询
玛米玛卡女童牛仔裤	0	0	0	0	0	0	0	0	0	0	0	0	0	0	0		批量查询
玛米玛卡女童打底裤	0	0	0	0	0	0	0	0	0	0	0	0	0	0	0		批量查询
玛米玛卡女童七分裤	0	0	0	0	0	0	0	0	0	0	0	0	0	0	0		批量查询
女童玛米玛卡运动裤	0	0	0	0	0	0	0	0	0	0	0	0	0	0	0		批量查询
玛米玛卡外套女春	0	0	0	0	0	0	0	0	0	0	0	0	0	0	0		批量查询
玛卡泡茶功效	0	0	0	0	0	0	0	0	0	0	0	0	0	0	0		批量查询
枸杞子和玛卡泡茶	0	0	0	0	0	0	0	0	0	0	0	0	0	0	0		批量查询
玛卡泡茶为何很苦	0	0	0	0	0	0	0	0	0	0	0	0	0	0	0		批量查询
玛卡泡茶喝有用吗	0	0	0	0	0	0	0	0	0	0	0	0	0	0	0		批量查询
玛卡能泡茶直接喝吗	0	0	0	0	0	0	0	0	0	0	0	0	0	0	0		批量查询
玛卡可以泡茶喝吗	0	0	0	0	0	0	0	0	0	0	0	0	0	0	0		批量查询
癫痫患者可吃玛卡粉吗	0	0	0	0	0	0	0	0	0	0	0	0	0	0	0		批量查询
中药材玛卡的作用	0	0	0	0	0	0	0	0	0	0	0	0	0	0	0		批量查询
塔县玛卡	0	0	0	0	0	0	0	0	0	0	0	0	0	0	0		批量查询
塔什库尔干县 玛卡	0	0	0	0	0	0	0	0	0	0	0	0	0	0	0		批量查询
塔什库尔干玛卡庄园	0	0	0	0	0	0	0	0	0	0	0	0	0	0	0		批量查询
玛卡精片效果怎么样	0	0	0	0	0	0	0	0	0	0	0	0	0	0	0		批量查询
巨青玛卡精片	0	0	0	0	0	0	0	0	0	0	0	0	0	0	0		批量查询
玛卡精片那个好	0	0	0	0	0	0	0	0	0	0	0	0	0	0	0		批量查询
什么品牌的玛卡精片好	0	0	0	0	0	0	0	0	0	0	0	0	0	0	0		批量查询
玛卡益康片好吗	0	0	0	0	0	0	0	0	0	0	0	0	0	0	0		批量查询
善元堂玛咖玛卡	0	0	0	0	0	0	0	0	0	0	0	0	0	0	0		批量查询
善元堂玛卡	0	0	0	0	0	0	0	0	0	0	0	0	0	0	0		批量查询
玛卡北京蜜蜂堂	0	0	0	0	0	0	0	0	0	0	0	0	0	0	0		批量查询
养仁堂 玛卡酒业	0	0	0	0	0	0	0	0	0	0	0	0	0	0	0		批量查询
姿一堂玛卡压片糖果	0	0	0	0	0	0	0	0	0	0	0	0	0	0	0		批量查询
玛卡堂	0	0	0	0	0	0	0	0	0	0	0	0	0	0	0		批量查询
伽玛卡兹鱼钩 角a1	0	0	0	0	0	0	0	0	0	0	0	0	0	0	0		批量查询
伽玛卡兹四角轴鱼钩	0	0	0	0	0	0	0	0	0	0	0	0	0	0	0		批量查询
玛卡招商	0	0	0	0	0	0	0	0	0	0	0	0	0	0	0		批量查询
玛卡胶囊 招商	0	0	0	0	0	0	0	0	0	0	0	0	0	0	0		批量查询
玛卡能量裤招商	0	0	0	0	0	0	0	0	0	0	0	0	0	0	0		批量查询
极卡玛卡	0	0	0	0	0	0	0	0	0	0	0	0	0	0	0		批量查询
七福玛卡	0	0	0	0	0	0	0	0	0	0	0	0	0	0	0		批量查询
云南假玛卡	0	0	0	0	0	0	0	0	0	0	0	0	0	0	0		批量查询
云南有假玛卡吗	0	0	0	0	0	0	0	0	0	0	0	0	0	0	0		批量查询
一公斤玛卡能泡多少酒	0	0	0	0	0	0	0	0	0	0	0	0	0	0	0		批量查询
玛卡酒泡制方法	0	0	0	0	0	0	0	0	0	0	0	0	0	0	0		批量查询
玛卡酒配方	0	0	0	0	0	0	0	0	0	0	0	0	0	0	0		批量查询
玛卡酒喝了有坏处吗	0	0	0	0	0	0	0	0	0	0	0	0	0	0	0		批量查询
2014春装玛卡西童装	0	0	0	0	0	0	0	0	0	0	0	0	0	0	0		批量查询
中药材 玛卡 介绍	0	0	0	0	0	0	0	0	0	0	0	0	0	0	0		批量查询
中药材玛卡怎食用	0	0	0	0	0	0	0	0	0	0	0	0	0	0	0		批量查询
中药材玛卡种子	0	0	0	0	0	0	0	0	0	0	0	0	0	0	0		批量查询
中药材玛卡价钱	0	0	0	0	0	0	0	0	0	0	0	0	0	0	0		批量查询
野生玛卡干片	0	0	0	0	0	0	0	0	0	0	0	0	0	0	0		批量查询
蔚达玛卡	0	0	0	0	0	0	0	0	0	0	0	0	0	0	0		批量查询
丽彩芳姿 女士玛卡	0	0	0	0	0	0	0	0	0	0	0	0	0	0	0		批量查询
活力达玛卡精片怎么样	0	0	0	0	0	0	0	0	0	0	0	0	0	0	0		批量查询
丽彩芳姿玛卡	0	0	0	0	0	0	0	0	0	0	0	0	0	0	0		批量查询
野生玛卡干果	0	0	0	0	0	0	0	0	0	0	0	0	0	0	0		批量查询
野生黑钻石玛卡	0	0	0	0	0	0	0	0	0	0	0	0	0	0	0		批量查询
云南野生玛卡干片	0	0	0	0	0	0	0	0	0	0	0	0	0	0	0		批量查询
新鲜的玛卡怎么保存好	0	0	0	0	0	0	0	0	0	0	0	0	0	0	0		批量查询
新鲜玛卡怎样保存	0	0	0	0	0	0	0	0	0	0	0	0	0	0	0		批量查询
玛卡干片泡酒	0	0	0	0	0	0	0	0	0	0	0	0	0	0	0		批量查询
玛卡要服用多长时间	0	0	0	0	0	0	0	0	0	0	0	0	0	0	0		批量查询
玛卡磨成粉后怎么使用	0	0	0	0	0	0	0	0	0	0	0	0	0	0	0		批量查询
玛卡女人能吃吗	0	0	0	0	0	0	0	0	0	0	0	0	0	0	0		批量查询
玛卡女人怎么吃	0	0	0	0	0	0	0	0	0	0	0	0	0	0	0		批量查询
女人可以吃玛卡吗	0	0	0	0	0	0	0	0	0	0	0	0	0	0	0		批量查询
玛卡女人能不能直接吃	0	0	0	0	0	0	0	0	0	0	0	0	0	0	0		批量查询
玛卡酒一次喝多少	0	0	0	0	0	0	0	0	0	0	0	0	0	0	0		批量查询
七福玛玛卡精片	0	0	0	0	0	0	0	0	0	0	0	0	0	0	0		批量查询
云南高原玛卡精片	0	0	0	0	0	0	0	0	0	0	0	0	0	0	0		批量查询
秘鲁玛卡600一斤	0	0	0	0	0	0	0	0	0	0	0	0	0	0	0		批量查询
玛卡干果的功效	0	0	0	0	0	0	0	0	0	0	0	0	0	0	0		批量查询
玛卡干果图片	0	0	0	0	0	0	0	0	0	0	0	0	0	0	0		批量查询
玛卡对女性有哪些作用	0	0	0	0	0	0	0	0	0	0	0	0	0	0	0		批量查询
玛卡对女性的作用	0	0	0	0	0	0	0	0	0	0	0	0	0	0	0		批量查询
玛卡对女性的功效	0	0	0	0	0	0	0	0	0	0	0	0	0	0	0		批量查询
玛卡女性可以吃吗	0	0	0	0	0	0	0	0	0	0	0	0	0	0	0		批量查询
拉摩力拉 玛卡	0	0	0	0	0	0	0	0	0	0	0	0	0	0	0		批量查询
丽江玛卡宝月种养基地	0	0	0	0	0	0	0	0	0	0	0	0	0	0	0		批量查询
玛卡泡酒的功效	0	0	0	0	0	0	0	0	0	0	0	0	0	0	0		批量查询
玛卡干果图	0	0	0	0	0	0	0	0	0	0	0	0	0	0	0		批量查询
黑钻玛卡 欲望之泉	0	0	0	0	0	0	0	0	0	0	0	0	0	0	0		批量查询
活力达玛卡精片	0	0	0	0	0	0	0	0	0	0	0	0	0	0	0		批量查询
式玛卡龙 昆山	0	0	0	0	0	0	0	0	0	0	0	0	0	0	0		批量查询
式玛卡龙集团	0	0	0	0	0	0	0	0	0	0	0	0	0	0	0		批量查询
ppg式玛卡龙	0	0	0	0	0	0	0	0	0	0	0	0	0	0	0		批量查询
式玛卡龙 厦门	0	0	0	0	0	0	0	0	0	0	0	0	0	0	0		批量查询
玛卡玛草片	0	0	0	0	0	0	0	0	0	0	0	0	0	0	0		批量查询
昆山式玛卡龙涂料	0	0	0	0	0	0	0	0	0	0	0	0	0	0	0		批量查询
式玛卡龙涂料有限公司	0	0	0	0	0	0	0	0	0	0	0	0	0	0	0		批量查询
式玛卡龙涂料 上海	0	0	0	0	0	0	0	0	0	0	0	0	0	0	0		批量查询
玛卡可以直接泡水喝吗	0	0	0	0	0	0	0	0	0	0	0	0	0	0	0		批量查询
玛卡泡水喝有什么用途	0	0	0	0	0	0	0	0	0	0	0	0	0	0	0		批量查询
玛卡泡水喝有效果吗	0	0	0	0	0	0	0	0	0	0	0	0	0	0	0		批量查询
玛卡泡水喝	0	0	0	0	0	0	0	0	0	0	0	0	0	0	0		批量查询
玛卡可以泡水喝吗	0	0	0	0	0	0	0	0	0	0	0	0	0	0	0		批量查询
玛卡能泡水喝吗	0	0	0	0	0	0	0	0	0	0	0	0	0	0	0		批量查询
玛卡泡水喝的效果好吗	0	0	0	0	0	0	0	0	0	0	0	0	0	0	0		批量查询
玛卡如何泡水喝	0	0	0	0	0	0	0	0	0	0	0	0	0	0	0		批量查询
云南纯植物玛卡	0	0	0	0	0	0	0	0	0	0	0	0	0	0	0		批量查询
云南有玛卡这种植物吗	0	0	0	0	0	0	0	0	0	0	0	0	0	0	0		批量查询
云南保山种植玛卡吗	0	0	0	0	0	0	0	0	0	0	0	0	0	0	0		批量查询
秘鲁玛卡 药材	0	0	0	0	0	0	0	0	0	0	0	0	0	0	0		批量查询
昭通玛卡种植	0	0	0	0	0	0	0	0	0	0	0	0	0	0	0		批量查询
云南种植玛卡的地方	0	0	0	0	0	0	0	0	0	0	0	0	0	0	0		批量查询
玛卡是一种什么药材	0	0	0	0	0	0	0	0	0	0	0	0	0	0	0		批量查询
万艾正品代购玛卡粒大鳄鱼	0	0	0	0	0	0	0	0	0	0	0	0	0	0	0		批量查询
玛卡干片有什么作用	0	0	0	0	0	0	0	0	0	0	0	0	0	0	0		批量查询
天然玛卡正品	0	0	0	0	0	0	0	0	0	0	0	0	0	0	0		批量查询
天然玛卡果	0	0	0	0	0	0	0	0	0	0	0	0	0	0	0		批量查询
天然玛卡片	0	0	0	0	0	0	0	0	0	0	0	0	0	0	0		批量查询
云南天然玛卡	0	0	0	0	0	0	0	0	0	0	0	0	0	0	0		批量查询
松古树美男性植物伟哥黑玛卡	0	0	0	0	0	0	0	0	0	0	0	0	0	0	0		批量查询
松古树美男性玛卡	0	0	0	0	0	0	0	0	0	0	0	0	0	0	0		批量查询
松古树美黑玛卡	0	0	0	0	0	0	0	0	0	0	0	0	0	0	0		批量查询
玛卡干片泡水	0	0	0	0	0	0	0	0	0	0	0	0	0	0	0		批量查询
玛卡干片泡水喝	0	0	0	0	0	0	0	0	0	0	0	0	0	0	0		批量查询
玛卡泡水喝的方法	0	0	0	0	0	0	0	0	0	0	0	0	0	0	0		批量查询
玛卡泡水的方法	0	0	0	0	0	0	0	0	0	0	0	0	0	0	0		批量查询
玛卡吃起来是什么味道	0	0	0	0	0	0	0	0	0	0	0	0	0	0	0		批量查询
玛卡吃起来什么味道	0	0	0	0	0	0	0	0	0	0	0	0	0	0	0		批量查询
玛卡嘴嚼片怎么吃	0	0	0	0	0	0	0	0	0	0	0	0	0	0	0		批量查询
云南补肾药材玛卡	0	0	0	0	0	0	0	0	0	0	0	0	0	0	0		批量查询
名贵药材玛卡礼品盒	0	0	0	0	0	0	0	0	0	0	0	0	0	0	0		批量查询
玛卡玛卡 女童	0	0	0	0	0	0	0	0	0	0	0	0	0	0	0		批量查询
玛卡 丽江	0	0	0	0	0	0	0	0	0	0	0	0	0	0	0		批量查询
玛卡 代购	0	0	0	0	0	0	0	0	0	0	0	0	0	0	0		批量查询
万艾可 正品代购 玛卡	0	0	0	0	0	0	0	0	0	0	0	0	0	0	0		批量查询
香港代购 玛卡	0	0	0	0	0	0	0	0	0	0	0	0	0	0	0		批量查询
玛卡美国代购	0	0	0	0	0	0	0	0	0	0	0	0	0	0	0		批量查询
玛卡产地及种植方法	0	0	0	0	0	0	0	0	0	0	0	0	0	0	0		批量查询
玛卡的形状和种植方法	0	0	0	0	0	0	0	0	0	0	0	0	0	0	0		批量查询
玛卡的产量和效益	0	0	0	0	0	0	0	0	0	0	0	0	0	0	0		批量查询
云南玛卡精片货到付款	0	0	0	0	0	0	0	0	0	0	0	0	0	0	0		批量查询
国产玛卡生产厂家	0	0	0	0	0	0	0	0	0	0	0	0	0	0	0		批量查询
秘鲁玛卡中国代理商	0	0	0	0	0	0	0	0	0	0	0	0	0	0	0		批量查询
松古树美玛卡40片	0	0	0	0	0	0	0	0	0	0	0	0	0	0	0		批量查询
松古树美玛卡精片	0	0	0	0	0	0	0	0	0	0	0	0	0	0	0		批量查询
松古树美玛卡 40	0	0	0	0	0	0	0	0	0	0	0	0	0	0	0		批量查询
松古树美玛卡80	0	0	0	0	0	0	0	0	0	0	0	0	0	0	0		批量查询
松古树美 男性玛卡	0	0	0	0	0	0	0	0	0	0	0	0	0	0	0		批量查询
松古树美 黑玛卡	0	0	0	0	0	0	0	0	0	0	0	0	0	0	0		批量查询
木氏玛卡	0	0	0	0	0	0	0	0	0	0	0	0	0	0	0		批量查询
木氏玛卡酒	0	0	0	0	0	0	0	0	0	0	0	0	0	0	0		批量查询
吃玛卡好吗	0	0	0	0	0	0	0	0	0	0	0	0	0	0	0		批量查询
云南的玛卡好吗	0	0	0	0	0	0	0	0	0	0	0	0	0	0	0		批量查询
备孕 吃玛卡好吗	0	0	0	0	0	0	0	0	0	0	0	0	0	0	0		批量查询
在香港买玛卡好吗	0	0	0	0	0	0	0	0	0	0	0	0	0	0	0		批量查询
早泄吃玛卡好吗	0	0	0	0	0	0	0	0	0	0	0	0	0	0	0		批量查询
南之和玛卡好吗	0	0	0	0	0	0	0	0	0	0	0	0	0	0	0		批量查询
前列腺患者吃玛卡好吗	0	0	0	0	0	0	0	0	0	0	0	0	0	0	0		批量查询
林芝玛卡	0	0	0	0	0	0	0	0	0	0	0	0	0	0	0		批量查询
玛卡对女人有什么作用	0	0	0	0	0	0	0	0	0	0	0	0	0	0	0		批量查询
云南玛卡庄园	0	0	0	0	0	0	0	0	0	0	0	0	0	0	0		批量查询
玛卡粉中药材	0	0	0	0	0	0	0	0	0	0	0	0	0	0	0		批量查询
中药材玛卡片	0	0	0	0	0	0	0	0	0	0	0	0	0	0	0		批量查询
玛卡生产企业北京办	0	0	0	0	0	0	0	0	0	0	0	0	0	0	0		批量查询
中药材玛卡个	0	0	0	0	0	0	0	0	0	0	0	0	0	0	0		批量查询
黒玛卡 中药材	0	0	0	0	0	0	0	0	0	0	0	0	0	0	0		批量查询
紫玛卡中药材	0	0	0	0	0	0	0	0	0	0	0	0	0	0	0		批量查询
松古树美男士玛卡80片	0	0	0	0	0	0	0	0	0	0	0	0	0	0	0		批量查询
松古树美男士玛卡精片	0	0	0	0	0	0	0	0	0	0	0	0	0	0	0		批量查询
怎样鉴别秘鲁玛卡	0	0	0	0	0	0	0	0	0	0	0	0	0	0	0		批量查询
秘鲁玛卡鉴别	0	0	0	0	0	0	0	0	0	0	0	0	0	0	0		批量查询
野口玛卡胶囊	0	0	0	0	0	0	0	0	0	0	0	0	0	0	0		批量查询
noguchi野口玛卡胶囊	0	0	0	0	0	0	0	0	0	0	0	0	0	0	0		批量查询
玛卡 拉摩 蛮哥哪个好	0	0	0	0	0	0	0	0	0	0	0	0	0	0	0		批量查询
拉摩拉力玛卡效果如何	0	0	0	0	0	0	0	0	0	0	0	0	0	0	0		批量查询
南京玛卡多咖啡商贸有限公司	0	0	0	0	0	0	0	0	0	0	0	0	0	0	0		批量查询
斯旺森swanson 秘鲁玛卡胶囊	0	0	0	0	0	0	0	0	0	0	0	0	0	0	0		批量查询
玛卡炖鸡的做法	0	0	0	0	0	0	0	0	0	0	0	0	0	0	0		批量查询
新鲜玛卡炖鸡的做法	0	0	0	0	0	0	0	0	0	0	0	0	0	0	0		批量查询
玛卡的做法	0	0	0	0	0	0	0	0	0	0	0	0	0	0	0		批量查询
新鲜玛卡的做法	0	0	0	0	0	0	0	0	0	0	0	0	0	0	0		批量查询
中药玛卡生长条件	0	0	0	0	0	0	0	0	0	0	0	0	0	0	0		批量查询
玛卡生长在哪里	0	0	0	0	0	0	0	0	0	0	0	0	0	0	0		批量查询
玛卡的生长周期	0	0	0	0	0	0	0	0	0	0	0	0	0	0	0		批量查询
玛卡生长在什么地方	0	0	0	0	0	0	0	0	0	0	0	0	0	0	0		批量查询
玛卡生长时间	0	0	0	0	0	0	0	0	0	0	0	0	0	0	0		批量查询
玛卡生长气候	0	0	0	0	0	0	0	0	0	0	0	0	0	0	0		批量查询
极卡纯玛卡洛阳工作室	0	0	0	0	0	0	0	0	0	0	0	0	0	0	0		批量查询
吃过玛卡的经历	0	0	0	0	0	0	0	0	0	0	0	0	0	0	0		批量查询
有人吃过玛卡么	0	0	0	0	0	0	0	0	0	0	0	0	0	0	0		批量查询
古之极玛卡精片	0	0	0	0	0	0	0	0	0	0	0	0	0	0	0		批量查询
玛卡多咖啡机	0	0	0	0	0	0	0	0	0	0	0	0	0	0	0		批量查询
云南玛卡产地	0	0	0	0	0	0	0	0	0	0	0	0	0	0	0		批量查询
丽江玛卡产地	0	0	0	0	0	0	0	0	0	0	0	0	0	0	0		批量查询
云南丽江玛卡产地	0	0	0	0	0	0	0	0	0	0	0	0	0	0	0		批量查询
秘鲁玛卡 产地	0	0	0	0	0	0	0	0	0	0	0	0	0	0	0		批量查询
玛卡在云南的产地	0	0	0	0	0	0	0	0	0	0	0	0	0	0	0		批量查询
玛卡到底的产地	0	0	0	0	0	0	0	0	0	0	0	0	0	0	0		批量查询
诺奥秘鲁玛卡胶囊	0	0	0	0	0	0	0	0	0	0	0	0	0	0	0		批量查询
玛卡切片服用方法	0	0	0	0	0	0	0	0	0	0	0	0	0	0	0		批量查询
玛卡精片的服用方法	0	0	0	0	0	0	0	0	0	0	0	0	0	0	0		批量查询
玛卡果真伪	0	0	0	0	0	0	0	0	0	0	0	0	0	0	0		批量查询
玛卡多咖啡豆	0	0	0	0	0	0	0	0	0	0	0	0	0	0	0		批量查询
玛卡多经典咖啡豆	0	0	0	0	0	0	0	0	0	0	0	0	0	0	0		批量查询
如何鉴别玛卡	0	0	0	0	0	0	0	0	0	0	0	0	0	0	0		批量查询
极卡纯玛卡精片	0	0	0	0	0	0	0	0	0	0	0	0	0	0	0		批量查询
古之极玛卡干片	0	0	0	0	0	0	0	0	0	0	0	0	0	0	0		批量查询
古之极玛卡云南	0	0	0	0	0	0	0	0	0	0	0	0	0	0	0		批量查询
古之极玛卡粉	0	0	0	0	0	0	0	0	0	0	0	0	0	0	0		批量查询
玛卡古之极旗舰店	0	0	0	0	0	0	0	0	0	0	0	0	0	0	0		批量查询
云南雪鼎玛卡	0	0	0	0	0	0	0	0	0	0	0	0	0	0	0		批量查询
雪鼎玛卡	0	0	0	0	0	0	0	0	0	0	0	0	0	0	0		批量查询
雪鼎玛卡评价	0	0	0	0	0	0	0	0	0	0	0	0	0	0	0		批量查询
谁用过雪鼎玛卡	0	0	0	0	0	0	0	0	0	0	0	0	0	0	0		批量查询
游仙尚品雪鼎玛卡	0	0	0	0	0	0	0	0	0	0	0	0	0	0	0		批量查询
批发雪鼎玛卡	0	0	0	0	0	0	0	0	0	0	0	0	0	0	0		批量查询
雪鼎玛卡怎么样	0	0	0	0	0	0	0	0	0	0	0	0	0	0	0		批量查询
拉摩力拉牌 玛卡 玛咖	0	0	0	0	0	0	0	0	0	0	0	0	0	0	0		批量查询
拉摩力秘鲁玛卡120粒	0	0	0	0	0	0	0	0	0	0	0	0	0	0	0		批量查询
拉摩力秘鲁玛卡	0	0	0	0	0	0	0	0	0	0	0	0	0	0	0		批量查询
gnc 秘鲁玛卡	0	0	0	0	0	0	0	0	0	0	0	0	0	0	0		批量查询
gnc 玛卡	0	0	0	0	0	0	0	0	0	0	0	0	0	0	0		批量查询
玛卡酰胺提取方法	0	0	0	0	0	0	0	0	0	0	0	0	0	0	0		批量查询
药材 玛卡酰胺	0	0	0	0	0	0	0	0	0	0	0	0	0	0	0		批量查询
玛卡酰胺检测	0	0	0	0	0	0	0	0	0	0	0	0	0	0	0		批量查询
玛卡酰胺对照品	0	0	0	0	0	0	0	0	0	0	0	0	0	0	0		批量查询
玛卡稀 玛卡酰胺	0	0	0	0	0	0	0	0	0	0	0	0	0	0	0		批量查询
玛卡烯	0	0	0	0	0	0	0	0	0	0	0	0	0	0	0		批量查询
玛卡干果500克	0	0	0	0	0	0	0	0	0	0	0	0	0	0	0		批量查询
原植物玛卡哪里有卖	0	0	0	0	0	0	0	0	0	0	0	0	0	0	0		批量查询
上海玛卡加工	0	0	0	0	0	0	0	0	0	0	0	0	0	0	0		批量查询
北京玛卡加工	0	0	0	0	0	0	0	0	0	0	0	0	0	0	0		批量查询
玛卡oem加工	0	0	0	0	0	0	0	0	0	0	0	0	0	0	0		批量查询
玛卡加工厂家	0	0	0	0	0	0	0	0	0	0	0	0	0	0	0		批量查询
丽彩方姿玛卡	0	0	0	0	0	0	0	0	0	0	0	0	0	0	0		批量查询
上海玛卡进出口贸易有限公司	0	0	0	0	0	0	0	0	0	0	0	0	0	0	0		批量查询
上海玛卡食品有限公司	0	0	0	0	0	0	0	0	0	0	0	0	0	0	0		批量查询
普丽普莱玛卡玛咖	0	0	0	0	0	0	0	0	0	0	0	0	0	0	0		批量查询
玛卡是啥	0	0	0	0	0	0	0	0	0	0	0	0	0	0	0		批量查询
秘鲁玛卡精粉	0	0	0	0	0	0	0	0	0	0	0	0	0	0	0		批量查询
明治玛卡	0	0	0	0	0	0	0	0	0	0	0	0	0	0	0		批量查询
康比特玛卡精华片	0	0	0	0	0	0	0	0	0	0	0	0	0	0	0		批量查询
玛卡干果批发	0	0	0	0	0	0	0	0	0	0	0	0	0	0	0		批量查询
玛卡益康片每瓶几粒	0	0	0	0	0	0	0	0	0	0	0	0	0	0	0		批量查询
玛卡 上海	0	0	0	0	0	0	0	0	0	0	0	0	0	0	0		批量查询
玛卡干果黑紫	0	0	0	0	0	0	0	0	0	0	0	0	0	0	0		批量查询
每粒坚玛卡精华素	0	0	0	0	0	0	0	0	0	0	0	0	0	0	0		批量查询
昆明鲜玛卡批发	0	0	0	0	0	0	0	0	0	0	0	0	0	0	0		批量查询
玛卡昆明哪里有卖	0	0	0	0	0	0	0	0	0	0	0	0	0	0	0		批量查询
玛卡鲜果特价	0	0	0	0	0	0	0	0	0	0	0	0	0	0	0		批量查询
玛卡鲜果 黑玛咖	0	0	0	0	0	0	0	0	0	0	0	0	0	0	0		批量查询
玛卡鲜果500克	0	0	0	0	0	0	0	0	0	0	0	0	0	0	0		批量查询
玛卡粉海关编码	0	0	0	0	0	0	0	0	0	0	0	0	0	0	0		批量查询
玛米玛卡儿童毛呢裙	0	0	0	0	0	0	0	0	0	0	0	0	0	0	0		批量查询
玛卡延时补肾茶	0	0	0	0	0	0	0	0	0	0	0	0	0	0	0		批量查询
丽江玛卡正品补肾	0	0	0	0	0	0	0	0	0	0	0	0	0	0	0		批量查询
拉摩力拉玛卡 2粒 3粒	0	0	0	0	0	0	0	0	0	0	0	0	0	0	0		批量查询
上海式玛卡龙涂料有限公司北京办事处	0	0	0	0	0	0	0	0	0	0	0	0	0	0	0		批量查询
式玛卡龙涂料 昆山 有限公司	0	0	0	0	0	0	0	0	0	0	0	0	0	0	0		批量查询
上海式玛卡龙涂料有限公司	0	0	0	0	0	0	0	0	0	0	0	0	0	0	0		批量查询
玛卡干果正品批发	0	0	0	0	0	0	0	0	0	0	0	0	0	0	0		批量查询
玛卡中国官方网站	0	0	0	0	0	0	0	0	0	0	0	0	0	0	0		批量查询
玛卡宣传视频	0	0	0	0	0	0	0	0	0	0	0	0	0	0	0		批量查询
玛卡益康有副作用吗	0	0	0	0	0	0	0	0	0	0	0	0	0	0	0		批量查询
玛卡益康 副作用	0	0	0	0	0	0	0	0	0	0	0	0	0	0	0		批量查询
玛卡秘鲁正品批发	0	0	0	0	0	0	0	0	0	0	0	0	0	0	0		批量查询
盘龙云海药业生产玛卡	0	0	0	0	0	0	0	0	0	0	0	0	0	0	0		批量查询
生产玛卡的公司有哪些	0	0	0	0	0	0	0	0	0	0	0	0	0	0	0		批量查询
哪里生产的玛卡质量好	0	0	0	0	0	0	0	0	0	0	0	0	0	0	0		批量查询
山东玛卡生产	0	0	0	0	0	0	0	0	0	0	0	0	0	0	0		批量查询
紫色玛卡干果	0	0	0	0	0	0	0	0	0	0	0	0	0	0	0		批量查询
云南玛卡招商	0	0	0	0	0	0	0	0	0	0	0	0	0	0	0		批量查询
招商加盟 玛咖 玛卡	0	0	0	0	0	0	0	0	0	0	0	0	0	0	0		批量查询
云南玛卡招商公司	0	0	0	0	0	0	0	0	0	0	0	0	0	0	0		批量查询
丽江紫玛卡 玛咖	0	0	0	0	0	0	0	0	0	0	0	0	0	0	0		批量查询
云南丽江紫玛卡	0	0	0	0	0	0	0	0	0	0	0	0	0	0	0		批量查询
新鲜玛卡酒怎么泡	0	0	0	0	0	0	0	0	0	0	0	0	0	0	0		批量查询
酒泡玛卡的比例是多少	0	0	0	0	0	0	0	0	0	0	0	0	0	0	0		批量查询
如何泡玛卡酒	0	0	0	0	0	0	0	0	0	0	0	0	0	0	0		批量查询
泡玛卡酒比例	0	0	0	0	0	0	0	0	0	0	0	0	0	0	0		批量查询
用多少度的酒泡玛卡	0	0	0	0	0	0	0	0	0	0	0	0	0	0	0		批量查询
一斤玛卡泡多少酒	0	0	0	0	0	0	0	0	0	0	0	0	0	0	0		批量查询
2h2d黑玛卡精片	0	0	0	0	0	0	0	0	0	0	0	0	0	0	0		批量查询
雪鼎黑玛卡精片	0	0	0	0	0	0	0	0	0	0	0	0	0	0	0		批量查询
黑玛卡胶囊精片	0	0	0	0	0	0	0	0	0	0	0	0	0	0	0		批量查询
紫色玛卡干片	0	0	0	0	0	0	0	0	0	0	0	0	0	0	0		批量查询
紫色玛卡干果 丽江	0	0	0	0	0	0	0	0	0	0	0	0	0	0	0		批量查询
紫色玛卡干果 500g	0	0	0	0	0	0	0	0	0	0	0	0	0	0	0		批量查询
紫色玛卡干片 500g	0	0	0	0	0	0	0	0	0	0	0	0	0	0	0		批量查询
紫色玛卡鲜果	0	0	0	0	0	0	0	0	0	0	0	0	0	0	0		批量查询
紫色玛卡种子	0	0	0	0	0	0	0	0	0	0	0	0	0	0	0		批量查询
紫色玛卡种	0	0	0	0	0	0	0	0	0	0	0	0	0	0	0		批量查询
秘鲁玛卡 紫色玛卡	0	0	0	0	0	0	0	0	0	0	0	0	0	0	0		批量查询
玛卡的药用功能	0	0	0	0	0	0	0	0	0	0	0	0	0	0	0		批量查询
玛卡功能饮料	0	0	0	0	0	0	0	0	0	0	0	0	0	0	0		批量查询
玛卡切片的保健功能	0	0	0	0	0	0	0	0	0	0	0	0	0	0	0		批量查询
类似玛卡	0	0	0	0	0	0	0	0	0	0	0	0	0	0	0		批量查询
男性延时 黄金玛卡	0	0	0	0	0	0	0	0	0	0	0	0	0	0	0		批量查询
黄金玛卡男用延时	0	0	0	0	0	0	0	0	0	0	0	0	0	0	0		批量查询
黄金玛卡延时保健	0	0	0	0	0	0	0	0	0	0	0	0	0	0	0		批量查询
黄金玛卡延时补肾	0	0	0	0	0	0	0	0	0	0	0	0	0	0	0		批量查询
黄金玛卡maca精片	0	0	0	0	0	0	0	0	0	0	0	0	0	0	0		批量查询
黄金玛卡maca粉	0	0	0	0	0	0	0	0	0	0	0	0	0	0	0		批量查询
黄金玛卡秘鲁maca	0	0	0	0	0	0	0	0	0	0	0	0	0	0	0		批量查询
黄金玛卡玛咖maca	0	0	0	0	0	0	0	0	0	0	0	0	0	0	0		批量查询
黄金玛卡干片maca	0	0	0	0	0	0	0	0	0	0	0	0	0	0	0		批量查询
云南玛卡骗局	0	0	0	0	0	0	0	0	0	0	0	0	0	0	0		批量查询
玛卡销售骗局	0	0	0	0	0	0	0	0	0	0	0	0	0	0	0		批量查询
玛卡磨成粉	0	0	0	0	0	0	0	0	0	0	0	0	0	0	0		批量查询
玛卡可以磨成粉吗	0	0	0	0	0	0	0	0	0	0	0	0	0	0	0		批量查询
玛卡磨成粉效果	0	0	0	0	0	0	0	0	0	0	0	0	0	0	0		批量查询
玛卡粉作用	0	0	0	0	0	0	0	0	0	0	0	0	0	0	0		批量查询
享硬玛卡延时片 正品	0	0	0	0	0	0	0	0	0	0	0	0	0	0	0		批量查询
享硬玛卡延时片	0	0	0	0	0	0	0	0	0	0	0	0	0	0	0		批量查询
享硬玛卡补肾增大	0	0	0	0	0	0	0	0	0	0	0	0	0	0	0		批量查询
玛卡干果 补肾	0	0	0	0	0	0	0	0	0	0	0	0	0	0	0		批量查询
玛卡什么品牌好	0	0	0	0	0	0	0	0	0	0	0	0	0	0	0		批量查询
哪个品牌的玛卡比较好	0	0	0	0	0	0	0	0	0	0	0	0	0	0	0		批量查询
云南玛卡什么品牌好	0	0	0	0	0	0	0	0	0	0	0	0	0	0	0		批量查询
玛卡那个品牌好	0	0	0	0	0	0	0	0	0	0	0	0	0	0	0		批量查询
玛卡和什么泡酒好	0	0	0	0	0	0	0	0	0	0	0	0	0	0	0		批量查询
松露和玛卡泡酒好吗	0	0	0	0	0	0	0	0	0	0	0	0	0	0	0		批量查询
玛卡泡水好还是泡酒好	0	0	0	0	0	0	0	0	0	0	0	0	0	0	0		批量查询
玛卡干药材泡酒好吗	0	0	0	0	0	0	0	0	0	0	0	0	0	0	0		批量查询
玛卡和那样泡酒好	0	0	0	0	0	0	0	0	0	0	0	0	0	0	0		批量查询
玛卡果泡酒好吗	0	0	0	0	0	0	0	0	0	0	0	0	0	0	0		批量查询
玛卡泡酒用什么颜色好	0	0	0	0	0	0	0	0	0	0	0	0	0	0	0		批量查询
玛卡配什么泡酒好	0	0	0	0	0	0	0	0	0	0	0	0	0	0	0		批量查询
什么颜色的鲜玛卡好	0	0	0	0	0	0	0	0	0	0	0	0	0	0	0		批量查询
什么颜色玛卡中药材好	0	0	0	0	0	0	0	0	0	0	0	0	0	0	0		批量查询
啥颜色的玛卡好	0	0	0	0	0	0	0	0	0	0	0	0	0	0	0		批量查询
野象玛卡酒	0	0	0	0	0	0	0	0	0	0	0	0	0	0	0		批量查询
野象玛卡精片	0	0	0	0	0	0	0	0	0	0	0	0	0	0	0		批量查询
野象玛卡玛咖酒	0	0	0	0	0	0	0	0	0	0	0	0	0	0	0		批量查询
玛卡黄精	0	0	0	0	0	0	0	0	0	0	0	0	0	0	0		批量查询
西藏正品野生黑玛卡	0	0	0	0	0	0	0	0	0	0	0	0	0	0	0		批量查询
昆明玛卡公司	0	0	0	0	0	0	0	0	0	0	0	0	0	0	0		批量查询
昆明玛卡收购	0	0	0	0	0	0	0	0	0	0	0	0	0	0	0		批量查询
黑玛卡种子 正品	0	0	0	0	0	0	0	0	0	0	0	0	0	0	0		批量查询
绿标正品防伪拉摩力拉maca玛卡	0	0	0	0	0	0	0	0	0	0	0	0	0	0	0		批量查询
玛卡适用年龄	0	0	0	0	0	0	0	0	0	0	0	0	0	0	0		批量查询
广西卫视 玛卡	0	0	0	0	0	0	0	0	0	0	0	0	0	0	0		批量查询
玛卡西尼春款	0	0	0	0	0	0	0	0	0	0	0	0	0	0	0		批量查询
玛卡西尼牛仔裤	0	0	0	0	0	0	0	0	0	0	0	0	0	0	0		批量查询
新鲜玛卡可以泡酒吗	0	0	0	0	0	0	0	0	0	0	0	0	0	0	0		批量查询
新鲜玛卡能泡酒吗	0	0	0	0	0	0	0	0	0	0	0	0	0	0	0		批量查询
黄金玛卡胶囊作用	0	0	0	0	0	0	0	0	0	0	0	0	0	0	0		批量查询
玛卡茶的功效	0	0	0	0	0	0	0	0	0	0	0	0	0	0	0		批量查询
秘鲁玛卡如意茶	0	0	0	0	0	0	0	0	0	0	0	0	0	0	0		批量查询
玛卡茶的价格	0	0	0	0	0	0	0	0	0	0	0	0	0	0	0		批量查询
玛卡茶	0	0	0	0	0	0	0	0	0	0	0	0	0	0	0		批量查询
美国代购 玛卡片	0	0	0	0	0	0	0	0	0	0	0	0	0	0	0		批量查询
美国gnc秘鲁man咖玛卡	0	0	0	0	0	0	0	0	0	0	0	0	0	0	0		批量查询
美国gnc秘鲁玛卡	0	0	0	0	0	0	0	0	0	0	0	0	0	0	0		批量查询
美国now foods秘鲁玛卡	0	0	0	0	0	0	0	0	0	0	0	0	0	0	0		批量查询
美国进口秘鲁玛卡	0	0	0	0	0	0	0	0	0	0	0	0	0	0	0		批量查询
美国gnc秘鲁玛卡maca	0	0	0	0	0	0	0	0	0	0	0	0	0	0	0		批量查询
正品美国gnc秘鲁玛卡	0	0	0	0	0	0	0	0	0	0	0	0	0	0	0		批量查询
玛卡收购公司	0	0	0	0	0	0	0	0	0	0	0	0	0	0	0		批量查询
玛咖酒玛卡酒百岁坊	0	0	0	0	0	0	0	0	0	0	0	0	0	0	0		批量查询
玛卡快速育苗技术	0	0	0	0	0	0	0	0	0	0	0	0	0	0	0		批量查询
玛卡育苗	0	0	0	0	0	0	0	0	0	0	0	0	0	0	0		批量查询
玛卡种子怎样育苗	0	0	0	0	0	0	0	0	0	0	0	0	0	0	0		批量查询
真假玛卡干片如何鉴别	0	0	0	0	0	0	0	0	0	0	0	0	0	0	0		批量查询
玛卡干果 散装	0	0	0	0	0	0	0	0	0	0	0	0	0	0	0		批量查询
怎样鉴别玛卡	0	0	0	0	0	0	0	0	0	0	0	0	0	0	0		批量查询
百度如何鉴别玛卡	0	0	0	0	0	0	0	0	0	0	0	0	0	0	0		批量查询
玛卡的质量鉴别方法	0	0	0	0	0	0	0	0	0	0	0	0	0	0	0		批量查询
怎样鉴别玛卡干果	0	0	0	0	0	0	0	0	0	0	0	0	0	0	0		批量查询
肾虚 补肾 男用 玛卡	0	0	0	0	0	0	0	0	0	0	0	0	0	0	0		批量查询
享硬秘鲁玛卡补肾	0	0	0	0	0	0	0	0	0	0	0	0	0	0	0		批量查询
伟延时增大补肾玛卡	0	0	0	0	0	0	0	0	0	0	0	0	0	0	0		批量查询
玛卡合作社	0	0	0	0	0	0	0	0	0	0	0	0	0	0	0		批量查询
玛卡适合哪类人吃	0	0	0	0	0	0	0	0	0	0	0	0	0	0	0		批量查询
玛卡切片适合什么人吃	0	0	0	0	0	0	0	0	0	0	0	0	0	0	0		批量查询
玛卡适合几岁人吃	0	0	0	0	0	0	0	0	0	0	0	0	0	0	0		批量查询
玛卡适合那些人吃	0	0	0	0	0	0	0	0	0	0	0	0	0	0	0		批量查询
玛卡适合什么人吃	0	0	0	0	0	0	0	0	0	0	0	0	0	0	0		批量查询
糖尿病人能吃玛卡吗	0	0	0	0	0	0	0	0	0	0	0	0	0	0	0		批量查询
吃玛卡有害吗	0	0	0	0	0	0	0	0	0	0	0	0	0	0	0		批量查询
玛卡对身体有害处吗	0	0	0	0	0	0	0	0	0	0	0	0	0	0	0		批量查询
秘鲁进口紫玛卡	0	0	0	0	0	0	0	0	0	0	0	0	0	0	0		批量查询
玛卡真有效嘛	0	0	0	0	0	0	0	0	0	0	0	0	0	0	0		批量查询
玛卡真的那么有效吗	0	0	0	0	0	0	0	0	0	0	0	0	0	0	0		批量查询
吃玛卡真有效么	0	0	0	0	0	0	0	0	0	0	0	0	0	0	0		批量查询
肾虚吃玛卡有用吗	0	0	0	0	0	0	0	0	0	0	0	0	0	0	0		批量查询
玛卡干价格是多少	0	0	0	0	0	0	0	0	0	0	0	0	0	0	0		批量查询
倍万斯玛卡	0	0	0	0	0	0	0	0	0	0	0	0	0	0	0		批量查询
黑玛卡 秘鲁 正品批发	0	0	0	0	0	0	0	0	0	0	0	0	0	0	0		批量查询
黑玛卡 秘鲁 正品补肾	0	0	0	0	0	0	0	0	0	0	0	0	0	0	0		批量查询
黑玛卡 秘鲁 正品 云南	0	0	0	0	0	0	0	0	0	0	0	0	0	0	0		批量查询
黑玛卡 秘鲁 正品 代购	0	0	0	0	0	0	0	0	0	0	0	0	0	0	0		批量查询
黑玛卡 秘鲁 正品 精片	0	0	0	0	0	0	0	0	0	0	0	0	0	0	0		批量查询
进口黑玛卡 秘鲁 正品	0	0	0	0	0	0	0	0	0	0	0	0	0	0	0		批量查询
秘鲁正品黑玛卡壮阳	0	0	0	0	0	0	0	0	0	0	0	0	0	0	0		批量查询
黑玛卡 粉秘鲁 正品	0	0	0	0	0	0	0	0	0	0	0	0	0	0	0		批量查询
日本黑玛卡 秘鲁 正品	0	0	0	0	0	0	0	0	0	0	0	0	0	0	0		批量查询
玛卡精粉价格	0	0	0	0	0	0	0	0	0	0	0	0	0	0	0		批量查询
极品黑玛卡干片	0	0	0	0	0	0	0	0	0	0	0	0	0	0	0		批量查询
黑玛咖 极品黑玛卡	0	0	0	0	0	0	0	0	0	0	0	0	0	0	0		批量查询
丽江极品黑玛卡	0	0	0	0	0	0	0	0	0	0	0	0	0	0	0		批量查询
哪种颜色玛卡果好	0	0	0	0	0	0	0	0	0	0	0	0	0	0	0		批量查询
伽玛卡兹 新款一彗	0	0	0	0	0	0	0	0	0	0	0	0	0	0	0		批量查询
关于玛卡	0	0	0	0	0	0	0	0	0	0	0	0	0	0	0		批量查询
玛卡干果特价	0	0	0	0	0	0	0	0	0	0	0	0	0	0	0		批量查询
香格里拉种玛卡吗	0	0	0	0	0	0	0	0	0	0	0	0	0	0	0		批量查询
香格里拉玛卡怎么样	0	0	0	0	0	0	0	0	0	0	0	0	0	0	0		批量查询
玛卡干果干片粉	0	0	0	0	0	0	0	0	0	0	0	0	0	0	0		批量查询
伽玛卡慈 凌波	0	0	0	0	0	0	0	0	0	0	0	0	0	0	0		批量查询
日本原装2h2d玛卡	0	0	0	0	0	0	0	0	0	0	0	0	0	0	0		批量查询
